meta	no_postings
canonical	no_postings
netflix	no_postings
microsoft	no_postings
alphabet	no_postings
amazon	no_postings
tesla	no_postings
google	no_postings
apple	no_postings
dell	no_postings
salesforce	no_postings
hpe	no_postings
broadcom	no_postings
cisco	no_postings
nvidia	no_postings
facebook	no_postings
intel	no_postings
adobe	no_postings
vmware	no_postings
suse	no_postings
oracle	no_postings
hp	no_postings
redhat	no_postings
ibm	no_postings
qualcomm	no_postings
amd	no_postings
openai	no_postings
anthropic	no_postings
huggingface	no_postings
cohere	no_postings
databricks	no_postings
datarobot	no_postings
scaleai	no_postings
c3ai	no_postings
snowflake	no_postings
palantir	no_matching_jobs
deepmind	no_postings
stability.ai	http_400
inflection	no_postings
midjourney	no_postings
mistral	no_postings
perplexity	no_postings
character.ai	http_400
copy.ai	http_400
adept	no_postings
jasper	no_postings
writesonic	no_postings
runway	no_postings
conjure	no_postings
synthesia	no_postings
descript	no_postings
typeface	no_postings
otter.ai	http_400
outreach	no_postings
people.ai	http_400
chorus.ai	http_400
fireflies.ai	http_400
clari	no_postings
salesloft	no_postings
gong	no_matching_jobs
apollo.io	http_400
6sense	no_postings
clearbit	no_postings
zoominfo	no_postings
chili piper	http_400
front	no_postings
calendly	no_postings
intercom	no_postings
drift	no_postings
mixmax	no_postings
superhuman	no_postings
qualified	no_postings
yesware	no_postings
groove	no_postings
demandbase	no_postings
spark	no_postings
hey	no_postings
protonmail	no_postings
newton	no_postings
tutanota	no_postings
spike	no_postings
hushmail	no_postings
mailbird	no_postings
aws	no_postings
polymail	no_postings
canary	no_postings
azure	no_postings
gcp	no_postings
digitalocean	no_postings
vultr	no_postings
linode	no_postings
cloudflare	no_postings
fastly	no_postings
akamai	no_postings
edgecast	no_postings
mongodb	no_postings
incapsula	no_postings
redis	no_postings
elastic	no_postings
sucuri	no_postings
imperva	no_postings
elasticsearch	no_postings
opensearch	no_postings
typesense	no_postings
algolia	no_postings
pulsar	no_postings
confluent	no_postings
solr	no_postings
rabbitmq	no_postings
meilisearch	no_postings
kafka	no_postings
zeromq	no_postings
tibco	no_postings
ibmmq	no_postings
nats	no_postings
activemq	no_postings
hashicorp	no_postings
rancher	no_postings
terraform	no_postings
kubernetes	no_postings
docker	no_postings
boundary	no_postings
consul	no_postings
vault	no_postings
waypoint	no_postings
nomad	no_postings
podman	no_postings
openshift	no_postings
eks	no_postings
aks	no_postings
netlify	no_postings
heroku	no_postings
vercel	no_postings
fly.io	http_400
cloudfoundry	no_postings
pivotal	no_postings
gke	no_postings
railway	no_postings
render	no_postings
glitch	no_postings
replit	no_postings
codesandbox	no_postings
stackblitz	no_postings
codespaces	no_postings
gitpod	no_postings
bitbucket	no_postings
daytona	no_postings
gitlab	no_postings
github	no_postings
jira	no_postings
atlassian	no_postings
coder	no_postings
confluence	no_postings
trello	no_postings
monday.com	http_400
asana	no_postings
clickup	no_postings
notion	no_postings
wrike	no_postings
coda	no_postings
airtable	no_postings
smartsheet	no_postings
teamwork	no_postings
basecamp	no_postings
workfront	no_postings
mavenlink	no_postings
clarizen	no_postings
liquidplanner	no_postings
harvest	no_postings
teamgantt	no_postings
scoro	no_postings
toggl	no_postings
timely	no_postings
projectmanager	no_matching_jobs
clockify	no_postings
hubstaff	no_postings
everhour	no_postings
time doctor	http_400
focusmate	no_postings
forest	no_postings
cold turkey	http_400
rescuetime	no_postings
freedom	no_postings
endel	no_postings
selfcontrol	no_postings
serene	no_postings
focus@will	http_400
brain.fm	http_400
stayfocusd	no_postings
leechblock	no_postings
ambient mixer	http_400
noisli	no_postings
sound of colleagues	http_400
coffitivity	no_postings
mynoise	no_postings
defonic	no_postings
rainy mood	http_400
rainymood	no_postings
asoftmurmur	no_postings
jazz and rain	http_400
sourceforge	no_postings
launchpad	no_postings
gitea	no_postings
gerrit	no_postings
phabricator	no_postings
crucible	no_postings
reviewboard	no_postings
gogs	no_postings
codebeat	no_postings
sonarsource	no_postings
sonarqube	no_postings
coverity	no_postings
codacy	no_postings
snyk	no_postings
checkmarx	no_postings
codeclimate	no_postings
veracode	no_postings
packagecloud	no_postings
whitesource	no_postings
blackduck	no_postings
gemfury	no_postings
artifactory	no_postings
cloudsmith	no_postings
jfrog	no_postings
npm	no_postings
nexus	no_postings
sonatype	no_postings
yarn	no_postings
pypi	no_postings
pnpm	no_postings
bower	no_postings
rubygems	no_postings
maven	no_postings
gradle	no_postings
nuget	no_postings
swift package manager	http_400
carthage	no_postings
cocoapods	no_postings
pub	no_postings
composer	no_postings
cargo	no_postings
rebar3	no_postings
leiningen	no_postings
mix	no_postings
stack	no_postings
cypress	no_postings
clojars	no_postings
cabal	no_postings
boot	no_postings
selenium	no_postings
hackage	no_postings
hex	no_postings
playwright	no_postings
testcafe	no_postings
protractor	no_postings
webdriverio	no_postings
puppeteer	no_postings
nightwatch	no_postings
katalon	no_postings
testim	no_postings
ranorex	no_postings
microfocus	no_postings
tricentis	no_postings
smartbear	no_postings
soapui	no_postings
testcomplete	no_postings
postman	no_postings
paw	no_postings
insomnia	no_postings
advanced rest client	http_400
rest-client	no_postings
talend	no_postings
httpie	no_postings
wget	no_postings
curl	no_postings
informatica	no_postings
alteryx	no_postings
domino	no_postings
rapidminer	no_postings
h2o.ai	http_400
knime	no_postings
anaconda	no_postings
dataiku	no_matching_jobs
jupyter	no_postings
observable	no_postings
mode	no_postings
zeppelin	no_postings
looker	no_postings
tableau	no_postings
qlik	no_postings
powerbi	no_postings
sisense	no_postings
domo	no_postings
thoughtspot	no_postings
microstrategy	no_postings
cognos	no_postings
sap	no_postings
pentaho	no_postings
jaspersoft	no_postings
businessobjects	no_postings
tibco spotfire	http_400
yellowfin	no_postings
checkout.com	http_400
klipfolio	no_postings
worldpay	no_postings
dasheroo	no_postings
databox	no_postings
fiserv	no_postings
square	no_postings
first data	http_400
braintree	no_postings
merchant e-solutions	http_400
bluepay	no_postings
block	no_postings
grow	no_postings
global payments	http_400
reportz	no_postings
tsys	no_postings
elavon	no_postings
cyfe	no_postings
payline	no_postings
authorize.net	http_400
fis	no_postings
stripe	no_postings
geckoboard	no_postings
fattmerchant	no_postings
adyen	no_postings
transnational payments	http_400
national processing	http_400
dharma merchant services	http_400
flagship merchant services	http_400
eprocessing network	http_400
payment depot	http_400
paypal	no_postings
samsungpay	no_postings
heartland	no_postings
clearent	no_matching_jobs
venmo	no_postings
goepay	no_postings
wechat pay	http_400
amazon pay	http_400
bhim	no_postings
mobikwik	no_postings
payoneer	no_postings
paytm	no_postings
phonepe	no_postings
gpay	no_postings
transferwise	no_postings
alipay	no_postings
freecharge	no_matching_jobs
wise	no_matching_jobs
host merchant services	http_400
googlepay	no_postings
stax	no_postings
durango merchant services	http_400
cayan	no_postings
cashapp	no_postings
applypay	no_postings
north american bancard	http_400
helcim	no_postings
zelle	no_postings
paymentcloud	no_postings
paymentus	no_postings
cdgcommerce	no_postings
remitly	no_postings
worldremit	no_postings
small world	http_400
xoom	no_postings
ria	no_postings
transfergo	no_postings
torfx	no_postings
azimo	no_postings
ofx	no_postings
currencyfair	no_postings
instarem	no_postings
moneygram	no_postings
westernunion	no_postings
uniteller	no_postings
transfast	no_postings
vigo	no_postings
dolex	no_postings
orlandi valuta	http_400
viamericas	no_postings
ace cash express	http_400
cashnetusa	no_postings
check into cash	http_400
check n go	http_400
rapid financial solutions	http_400
sigue	no_postings
check city	http_400
moneytree	no_postings
titlemax	no_postings
money mart	http_400
amscot	no_postings
community financial services	http_400
qc holdings	http_400
loanmax	no_postings
checkmart	no_postings
pls	no_postings
jpmorgan	no_postings
chase	no_postings
jpmorganchase	no_postings
bofa	no_postings
wellsfargo	no_postings
bankofamerica	no_postings
citigroup	no_postings
citi	no_postings
citibank	no_postings
usbank	no_postings
fifth third	http_400
td bank	http_400
truist	no_postings
citizens	no_postings
pnc	no_postings
huntington	no_postings
regions	no_postings
m&t bank	http_400
first horizon	http_400
bok financial	http_400
synovus	no_postings
valley national	http_400
zions	no_postings
comerica	no_postings
cullen frost	http_400
keycorp	no_postings
silicon valley bank	http_400
signature bank	http_400
webster	no_postings
first republic	http_400
western alliance	http_400
east west bank	http_400
pacwest	no_postings
banner	no_postings
umpqua	no_postings
columbia	no_postings
cathay	no_postings
nbh bank	http_400
first interstate	http_400
glacier	no_postings
texas capital	http_400
united community banks	http_400
home bancshares	http_400
atlantic union	http_400
prosperity	no_postings
southstate	no_postings
old national	http_400
first citizens	http_400
simmons	no_postings
ameris	no_postings
pinnacle	no_postings
hope bancorp	http_400
華美銀行	http_400
華僑銀行	http_400
中國信託	http_400
cadence	no_postings
玉山銀行	http_400
國泰世華	http_400
聯邦銀行	http_400
台新銀行	http_400
第一銀行	http_400
華南銀行	http_400
土地銀行	http_400
合作金庫	http_400
彰化銀行	http_400
台灣銀行	http_400
中國銀行	http_400
建設銀行	http_400
兆豐銀行	http_400
農業銀行	http_400
工商銀行	http_400
交通銀行	http_400
招商銀行	http_400
興業銀行	http_400
中信銀行	http_400
民生銀行	http_400
浦發銀行	http_400
光大銀行	http_400
廣發銀行	http_400
平安銀行	http_400
華夏銀行	http_400
渤海銀行	http_400
恆豐銀行	http_400
bofa securities	http_400
deutsche bank	http_400
goldmansachs	no_postings
credit suisse	http_400
morganstanley	no_postings
ubs	no_postings
barclays	no_postings
hsbc	no_postings
bnp paribas	http_400
societe generale	http_400
unicredit	no_postings
santander	no_postings
natixis	no_postings
ing	no_postings
bbva	no_postings
mizuho	no_postings
nomura	no_postings
smbc nikko	http_400
daiwa	no_postings
jefferies	no_postings
evercore	no_postings
lazard	no_postings
pjt partners	http_400
moelis	no_postings
perella weinberg	http_400
houlihan lokey	http_400
centerview	no_postings
guggenheim	no_postings
greenhill	no_postings
rothschild	no_postings
raine group	http_400
allen & company	http_400
raymond james	http_400
lионgate	http_400
qatalyst	no_postings
piper sandler	http_400
william blair	http_400
stifel	no_matching_jobs
baird	no_postings
stephens	no_postings
cowen	no_postings
craig hallum	http_400
needham	no_postings
lake street	http_400
wedbush	no_postings
oppenheimer	no_postings
dа davidson	http_400
roth capital	http_400
benchmark	no_postings
b riley	http_400
telsey	no_postings
btig	no_postings
loop capital	http_400
imperial capital	http_400
maxim group	http_400
ladenburg	no_postings
noble capital	http_400
alliance global	http_400
small cap capital markets	http_400
aegis capital	http_400
ascendiant capital	http_400
chardan	no_postings
crystal research	http_400
axiom capital	http_400
h.c. wainwright	http_400
kingswood	no_postings
national securities	http_400
laidlaw	no_postings
hallum	no_postings
rodman & renshaw	http_400
pi financial	http_400
taglich brothers	http_400
kkr	no_postings
blackstone	no_postings
wainwright	no_postings
carlyle	no_postings
apollo	no_postings
warburg pincus	http_400
tpg	no_postings
vista equity	http_400
advent	no_postings
thoma bravo	http_400
silver lake	http_400
general atlantic	http_400
cvc	no_postings
pai partners	http_400
cinven	no_postings
hellman & friedman	http_400
permira	no_postings
bc partners	http_400
bain capital	http_400
leonard green	http_400
providence equity	http_400
fortress	no_postings
oaktree	no_postings
neuberger berman	http_400
ares	no_postings
brookfield	no_postings
bridgewater	no_postings
millennium	no_postings
two sigma	http_400
citadel	no_postings
renaissance technologies	http_400
de shaw	http_400
aqr	no_postings
winton	no_postings
man group	http_400
marshall wace	http_400
point72	no_postings
balyasny	no_postings
renaissance	no_postings
andreessen horowitz	http_400
sequoia	no_postings
a16z	no_postings
accel	no_postings
greylock	no_postings
tiger global	http_400
insight partners	http_400
kleiner perkins	http_400
index ventures	http_400
coatue	no_postings
bessemer	no_postings
iconiq	no_postings
nea	no_postings
lightspeed	no_postings
battery ventures	http_400
mayfield	no_postings
foundry group	http_400
spark capital	http_400
union square ventures	http_400
first round	http_400
khosla ventures	http_400
redpoint	no_postings
lux capital	http_400
founders fund	http_400
ribbit capital	http_400
sands capital	http_400
durable capital	http_400
addition	no_postings
altimeter	no_postings
dragoneer	no_postings
viking global	http_400
whale rock	http_400
jana partners	http_400
d1 capital	http_400
darsana	no_postings
lone pine	http_400
greenoaks	no_postings
glenview	no_postings
elliott management	http_400
soroban	no_postings
pershing square	http_400
third point	http_400
trian	no_postings
valueact	no_postings
carl icahn	http_400
nelson peltz	http_400
starboard	no_postings
bill ackman	http_400
dan loeb	http_400
jeff smith	http_400
jeff ubben	http_400
keith meister	http_400
barry rosenstein	http_400
citadel securities	http_400
virtu	no_postings
jump trading	http_400
flow traders	http_400
tower research	http_400
hudson river trading	http_400
akuna capital	http_400
five rings	http_400
imc	no_postings
optiver	no_postings
sig	no_postings
drw	no_postings
jane street	http_400
old mission	http_400
headlands tech	http_400
group one	http_400
wolverine	no_postings
galaxy digital	http_400
cumberland	no_postings
wintermute	no_postings
coinbase	no_postings
circle	no_postings
kraken	no_postings
okx	no_postings
gemini	no_postings
bitfinex	no_postings
bittrex	no_postings
bitstamp	no_postings
gate.io	http_400
poloniex	no_postings
binance	no_matching_jobs
huobi	no_postings
bybit	no_postings
kucoin	no_postings
crypto.com	http_400
celsius	no_postings
blockfi	no_postings
ftx	no_postings
nexo	no_postings
ledn	no_postings
unchained capital	http_400
salt lending	http_400
babel finance	http_400
hodlnaut	no_postings
vauld	no_postings
genesis	no_postings
paxos	no_postings
fireblocks	no_postings
bitgo	no_postings
coinloan	no_postings
anchorage	no_postings
ledger	no_postings
ngrave	no_postings
trezor	no_postings
coldcard	no_postings
cobo	no_postings
ellipal	no_postings
arculus	no_postings
safepal	no_postings
keystone	no_postings
avalanche	no_postings
polygon	no_postings
gridplus	no_postings
chainlink	no_postings
consensys	no_postings
near	no_postings
algorand	no_postings
solana	no_postings
cosmos	no_postings
cardano	no_postings
polkadot	no_postings
fantom	no_postings
terra	no_postings
harmony	no_postings
elrond	no_postings
hedera	no_postings
tezos	no_postings
neo	no_postings
waves	no_postings
icon	no_postings
tron	no_postings
eos	no_postings
graph protocol	http_400
filecoin	no_postings
chainlink labs	http_400
vechain	no_postings
ontology	no_postings
arweave	no_postings
zilliqa	no_postings
theta	no_postings
ocean protocol	http_400
storj	no_postings
rarible	no_postings
audius	no_postings
livepeer	no_postings
magic eden	http_400
opensea	no_postings
x2y2	no_postings
looksrare	no_postings
blur	no_postings
sia	no_matching_jobs
foundation	no_postings
async art	http_400
nifty gateway	http_400
known origin	http_400
superrare	no_postings
makersplace	no_postings
bored ape yacht club	http_400
veefriends	no_postings
clone x	http_400
doodles	no_postings
azuki	no_postings
world of women	http_400
cryptopunks	no_postings
moonbirds	no_postings
pudgy penguins	http_400
cool cats	http_400
forgotten runes	http_400
goblintown	no_postings
cryptoadz	no_postings
art blocks	http_400
meebits	no_postings
nouns	no_postings
vee friends	http_400
decentraland	no_postings
otherside	no_postings
sandbox	no_postings
axie infinity	http_400
illuvium	no_postings
star atlas	http_400
big time	http_400
gods unchained	http_400
gala games	http_400
enjin	no_postings
immutable x	http_400
dapper labs	http_400
nfl all day	http_400
nba top shot	http_400
wax	no_postings
flow	no_postings
ufc strike	http_400
laliga golazos	http_400
mlb champions	http_400
formula 1	http_400
disney pinnacle	http_400
solitaire blitz	http_400
star trek continuum	http_400
aave	no_postings
uniswap	no_postings
curve	no_postings
makerdao	no_postings
compound	no_postings
convex	no_postings
yearn	no_postings
synthetix	no_postings
pancakeswap	no_postings
balancer	no_postings
1inch	no_postings
sushiswap	no_postings
kyber	no_postings
paraswap	no_postings
cowswap	no_postings
matcha	no_postings
bancor	no_postings
dydx	no_postings
gmx	no_postings
gains network	http_400
perpetual protocol	http_400
level finance	http_400
apollox	no_postings
mux protocol	http_400
vertex	no_postings
lyra	no_matching_jobs
umami finance	http_400
ribbon finance	http_400
jones dao	http_400
dopex	no_postings
vesta finance	http_400
pika protocol	http_400
kwenta	no_postings
gns	no_postings
rage trade	http_400
tigris trade	http_400
mummy finance	http_400
mycelium	no_postings
polynomial	no_postings
hippo	no_postings
handlefi	no_postings
root	no_postings
lemonade	no_postings
kin	no_postings
openly	no_postings
metromile	no_postings
clearcover	no_postings
next	no_postings
policygenius	no_postings
sure	no_postings
zego	no_postings
trov	no_postings
slice	no_postings
cuvva	no_postings
getsafe	no_postings
bought by many	http_400
shift technology	http_400
snapsheet	no_postings
tractable	no_postings
hi marley	http_400
cape analytics	http_400
breathe life	http_400
livegamic	no_postings
bestow	no_postings
haven life	http_400
ladder	no_postings
betterview	no_postings
ethos	no_postings
fabric	no_postings
kindur	no_postings
quotacy	no_postings
wysh	no_postings
naviplan	no_postings
rightsizing	no_postings
the zebra	http_400
coverage cat	http_400
insurify	no_postings
jerry	no_postings
gabi	no_postings
assurance	no_postings
iq	no_postings
policyfly	no_postings
breeze	no_postings
savvy	no_postings
zillow	no_postings
redfin	no_postings
coverbund	no_postings
offerpad	no_postings
compass	no_postings
realogy	no_postings
opendoor	no_postings
homelight	no_postings
knock	no_postings
anywhere	no_postings
christies	no_postings
corcoran	no_postings
sothebys	no_postings
coldwell banker	http_400
century 21	http_400
better homes	http_400
jll	no_postings
cbre	no_postings
cushman wakefield	http_400
newmark	no_postings
engel völkers	http_400
era	no_postings
berkshire hathaway	http_400
savills	no_postings
knight frank	http_400
colliers	no_matching_jobs
exp realty	http_400
remax	no_postings
keller williams	http_400
howard hanna	http_400
long foster	http_400
edina realty	http_400
ben kinney	http_400
weichert	no_postings
windermere	no_postings
climb real estate	http_400
side	no_postings
ylopo	no_postings
opcity	no_postings
cinc	no_postings
lion desk	http_400
bold leads	http_400
market leader	http_400
boomtown	no_postings
follow up boss	http_400
kvcore	no_postings
wise agent	http_400
ixact contact	http_400
chime	no_postings
lofty	no_postings
contactually	no_postings
top producer	http_400
propertybase	no_postings
realvolve	no_postings
velocify	no_postings
dotloop	no_postings
skyslope	no_postings
zipforms	no_postings
docusign	no_matching_jobs
evernote	no_postings
dropbox	no_postings
google drive	http_400
box	no_postings
onedrive	no_postings
icloud	no_postings
zoho docs	http_400
egnyte	no_postings
smartvault	no_postings
syncplicity	no_postings
pcloud	no_postings
sugarsync	no_postings
sync.com	http_400
tresorit	no_postings
icedrive	no_postings
filen	no_postings
4shared	no_postings
mediafire	no_postings
sendspace	no_postings
internxt	no_postings
mega	no_postings
zippyshare	no_postings
rapidgator	no_postings
nitroflare	no_postings
uploaded	no_postings
keep2share	no_postings
turbobit	no_postings
fboom	no_postings
uptobox	no_postings
filejoker	no_postings
appfolio	no_postings
resman	no_postings
buildium	no_matching_jobs
yardi	no_matching_jobs
tenant cloud	http_400
rent manager	http_400
realpage	no_postings
entrata	no_postings
propertyware	no_postings
apartments.com	http_400
avail	no_postings
cozy	no_postings
zillow rental	http_400
padmapper	no_postings
rent.com	http_400
hotpads	no_postings
rentometer	no_postings
renthop	no_postings
lovely	no_postings
abodo	no_postings
zumper	no_postings
apartment list	http_400
dwellsy	no_postings
trulia rentals	http_400
furnished finder	http_400
doorsteps	no_postings
zeus living	http_400
landing	no_postings
lyric	no_postings
domio	no_postings
sonder	no_postings
stay alfred	http_400
blueground	no_postings
kasa	no_postings
mint house	http_400
locale	no_postings
starcity	no_postings
sentral	no_postings
whyhotel	no_postings
ollie	no_postings
node	no_postings
common	no_postings
coliwoo	no_postings
hmlet	no_postings
habyt	no_postings
the collective	http_400
urban campus	http_400
x+living	http_400
quarters	no_postings
welive	no_postings
ebay	no_postings
etsy	no_postings
shopify	no_postings
bestbuy marketplace	http_400
target plus	http_400
lowes	no_postings
walmart marketplace	http_400
homedepot	no_postings
costco	no_postings
samsclub	no_postings
albertsons	no_postings
publix	no_postings
kroger	no_postings
wegmans	no_postings
safeway	no_postings
food lion	http_400
giant eagle	http_400
meijer	no_postings
hy-vee	no_postings
fred meyer	http_400
harris teeter	http_400
ralphs	no_postings
king soopers	http_400
city market	http_400
dillons	no_postings
smiths	no_postings
mariano's	http_400
pick n save	http_400
qfc	no_postings
frys	no_postings
metro market	http_400
baker's	http_400
gerbes	no_postings
copps	no_postings
pay less	http_400
scott's	http_400
owen's	http_400
roundys	no_postings
shoppers food	http_400
jay c	http_400
ruler foods	http_400
cub foods	http_400
farm fresh	http_400
hornbachers	no_postings
cash wise	http_400
thrifty white	http_400
coborn's	http_400
sun fresh	http_400
price chopper	http_400
farfetch	no_postings
ssense	no_postings
net-a-porter	no_postings
matches fashion	http_400
mytheresa	no_postings
24s	no_postings
luisaviaroma	no_postings
browns	no_postings
revolve	no_postings
nasty gal	http_400
forward	no_matching_jobs
prettylittlething	no_postings
fashion nova	http_400
boohoo	no_postings
shein	no_postings
romwe	no_postings
asos	no_matching_jobs
missguided	no_postings
zaful	no_postings
yesstyle	no_postings
dollskill	no_postings
princess polly	http_400
amiclubwear	no_postings
showpo	no_postings
beginning boutique	http_400
peppermayo	no_postings
meshki	no_postings
white fox	http_400
meshki boutique	http_400
oh polly	http_400
i saw it first	http_400
in the style	http_400
rebellious fashion	http_400
forever 21	http_400
house of cb	http_400
edikted	no_postings
h&m	http_400
babyboo fashion	http_400
pull&bear	http_400
zara	no_postings
massimo dutti	http_400
&other stories	http_400
bershka	no_postings
cos	no_postings
stradivarius	no_postings
monki	no_postings
weekday	no_postings
uniqlo	no_postings
arket	no_postings
gu	no_postings
muji	no_postings
theory	no_postings
j.crew	http_400
old navy	http_400
madewell	no_postings
banana republic	http_400
gap	no_postings
american eagle	http_400
athleta	no_postings
hollister	no_postings
aerie	no_postings
abercrombie	no_postings
free people	http_400
anthropologie	no_postings
urban outfitters	http_400
mr porter	http_400
the outnet	http_400
yoox	no_postings
terrain	no_postings
harvey nichols	http_400
harrods	no_postings
selfridges	no_postings
liberty london	http_400
fortnum mason	http_400
bhldn	no_postings
neiman marcus	http_400
bergdorf goodman	http_400
saks fifth avenue	http_400
bloomingdales	no_postings
nordstrom	no_postings
barneys	no_postings
henri bendel	http_400
lord & taylor	http_400
gilt	no_postings
rue la la	http_400
beyond the rack	http_400
ideeli	no_postings
zulily	no_postings
one kings lane	http_400
totsy	no_postings
hautelook	no_postings
joss & main	http_400
fab	no_postings
wayfair	no_matching_jobs
article	no_postings
overstock	no_postings
houzz	no_postings
burrow	no_postings
castlery	no_postings
apt2b	no_postings
floyd	no_postings
maiden home	http_400
interior define	http_400
benchmade modern	http_400
inside weather	http_400
campaign	no_postings
joybird	no_postings
medley	no_postings
sabai	no_postings
poly & bark	http_400
thuma	no_postings
allform	no_postings
tuft & needle	http_400
purple	no_postings
nectar	no_postings
leesa	no_postings
casper	no_postings
helix	no_postings
saatva	no_postings
brooklyn bedding	http_400
avocado	no_postings
bear	no_postings
loom & leaf	http_400
layla	no_postings
amerisleep	no_postings
dreamcloud	no_postings
endy	no_postings
silk & snow	http_400
birch	no_postings
winkbed	no_postings
douglas	no_postings
polysleep	no_postings
novosbed	no_postings
recore	no_postings
logan & cove	http_400
silk and snow	http_400
alexander signature	http_400
nest bedding	http_400
ghost bed	http_400
goodmorning.com	http_400
bloom	no_matching_jobs
west elm	http_400
ikea	no_postings
brooklyn aurora	http_400
pottery barn	http_400
pottery barn kids	http_400
pottery barn teen	http_400
williams sonoma	http_400
mark and graham	http_400
rejuvenation	no_postings
crate and barrel	http_400
rh contemporary	http_400
land of nod	http_400
restoration hardware	http_400
rh baby child	http_400
rh teen	http_400
cb2	no_postings
room & board	http_400
herman miller	http_400
design within reach	http_400
steelcase	no_postings
knoll	no_postings
teknion	no_postings
haworth	no_postings
kimball	no_postings
basyx	no_postings
hon	no_postings
rh modern	http_400
allsteel	no_postings
global	no_postings
offices to go	http_400
cherryman	no_postings
mayline	no_postings
safco	no_postings
lorell	no_postings
office star	http_400
flash furniture	http_400
poly and bark	http_400
modway	no_postings
boss	no_postings
fine mod imports	http_400
lexmod	no_postings
diamond sofa	http_400
emodern	no_postings
zuo modern	http_400
nuevo	no_postings
nuevo living	http_400
armen living	http_400
lumisource	no_postings
baxton studio	http_400
sunpan	no_postings
sephora	no_postings
bluemercury	no_postings
space nk	http_400
ulta	no_postings
cult beauty	http_400
feel unique	http_400
beauty bay	http_400
lookfantastic	no_postings
beautylish	no_postings
dermstore	no_postings
paula's choice	http_400
skinstore	no_postings
lovelyskin	no_postings
the ordinary	http_400
drunk elephant	http_400
glossier	no_postings
fresh	no_postings
tatcha	no_postings
la mer	http_400
kiehl's	http_400
estee lauder	http_400
shiseido	no_postings
clinique	no_postings
sk-ii	no_postings
lancome	no_postings
ysl beauty	http_400
dior beauty	http_400
tom ford beauty	http_400
giorgio armani	http_400
givenchy	no_postings
burberry beauty	http_400
guerlain	no_postings
chanel beauty	http_400
sisley	no_matching_jobs
la prairie	http_400
valmont	no_postings
swiss perfection	http_400
cellular	no_postings
swiss line	http_400
sarah chapman skinesis	http_400
sarah chapman	http_400
augustinus bader	http_400
111skin	no_postings
revision skincare	http_400
biologique recherche	http_400
zo skin health	http_400
obagi	no_postings
isdin	no_postings
elta md	http_400
colorescience	no_postings
neostrata	no_postings
la roche posay	http_400
skinceuticals	no_postings
exuviance	no_postings
vichy	no_postings
neutrogena	no_postings
cerave	no_postings
cetaphil	no_postings
eucerin	no_postings
aveeno	no_postings
vanicream	no_postings
aquaphor	no_postings
nivea	no_postings
pond's	http_400
dove	no_postings
olay	no_postings
iherb	no_postings
vitacost	no_postings
swanson	no_postings
puritan's pride	http_400
natural factors	http_400
jarrow formulas	http_400
life extension	http_400
now foods	http_400
source naturals	http_400
doctor's best	http_400
bluebonnet	no_postings
solgar	no_postings
nature made	http_400
nature's way	http_400
nature's bounty	http_400
centrum	no_postings
one a day	http_400
vitafusion	no_postings
gummy vitamins	http_400
new chapter	http_400
smartypants	no_postings
garden of life	http_400
mary ruth organics	http_400
megafood	no_postings
rainbow light	http_400
innate response	http_400
enzymedica	no_postings
culturelle	no_postings
renew life	http_400
align	no_postings
miralax	no_postings
phillips	no_postings
florastor	no_postings
metamucil	no_postings
benefiber	no_postings
citrucel	no_postings
fiber choice	http_400
konsyl	no_postings
fibercon	no_postings
equalactin	no_postings
perdiem	no_postings
senokot	no_postings
dulcolax	no_postings
milk of magnesia	http_400
correctol	no_postings
ex-lax	no_postings
fleet	no_postings
pedia-lax	no_postings
glycerin suppositories	http_400
bisacodyl	no_postings
docusate	no_postings
magnesium hydroxide	http_400
cascara	no_postings
senna	no_postings
mannitol	no_postings
sorbitol	no_postings
polyethylene glycol	http_400
hellofresh	no_postings
sunbasket	no_postings
lactulose	no_postings
greenchef	no_postings
blueapron	no_postings
homeчеf	http_400
dinnerly	no_postings
everyplate	no_postings
gobble	no_postings
marley spoon	http_400
freshly	no_postings
factor	no_postings
magic kitchen	http_400
freshology	no_postings
territory	no_postings
bistromd	no_postings
diet-to-go	no_postings
nutrisystem	no_matching_jobs
mom's meals	http_400
trifecta	no_postings
fit n fresh	http_400
silver cuisine	http_400
clean eatz	http_400
metabolic meals	http_400
snap kitchen	http_400
clean creations	http_400
eat clean bro	http_400
my fit foods	http_400
prep to your door	http_400
icon meals	http_400
fit mens cook	http_400
muscle meals 2 go	http_400
eat the 80	http_400
prep kitchen	http_400
fitlife foods	http_400
power supply	http_400
trifecta nutrition	http_400
factor meals	http_400
fresh n lean	http_400
green chef	http_400
hungryroot	no_postings
purple carrot	http_400
sakara life	http_400
mosaic foods	http_400
the good kitchen	http_400
splendid spoon	http_400
provenance meals	http_400
daily harvest	http_400
clean eatz kitchen	http_400
eat clean tc	http_400
kettlebell kitchen	http_400
cooksimple	no_postings
methodology	no_postings
instacart	no_postings
shipt	no_postings
whole foods delivery	http_400
amazon fresh	http_400
kroger delivery	http_400
walmart grocery	http_400
target delivery	http_400
doordash	no_postings
ubereats	no_postings
grubhub	no_postings
seamless	no_postings
postmates	no_postings
caviar	no_postings
chownow	no_postings
olo	no_postings
toast	no_postings
clover	no_postings
lavu	no_postings
epos now	http_400
upserve	no_postings
touchbistro	no_postings
revel	no_postings
vend	no_postings
shopkeep	no_postings
kounta	no_postings
loyverse	no_postings
talech	no_postings
ehopper	no_postings
3s pos	http_400
cheddar up	http_400
tillpoint	no_postings
square for restaurants	http_400
toast pos	http_400
touchbistro pos	http_400
lightspeed restaurant	http_400
upserve pos	http_400
lavu pos	http_400
shopkeep pos	http_400
revel systems	http_400
vend pos	http_400
epos now pos	http_400
kounta pos	http_400
talech pos	http_400
loyverse pos	http_400
ehopper pos	http_400
3s pos system	http_400
tillpoint pos	http_400
instagram	no_postings
twitter	no_postings
linkedin	no_postings
reddit	no_postings
snapchat	no_postings
pinterest	no_postings
twitch	no_postings
youtube	no_postings
tiktok	no_postings
discord	no_postings
telegram	no_postings
whatsapp	no_postings
signal	no_postings
line	no_postings
viber	no_postings
kakaotalk	no_postings
wechat	no_postings
weibo	no_postings
qq	no_postings
douyin	no_postings
zhihu	no_postings
momo	no_postings
kuaishou	no_postings
bilibili	no_postings
xiaohongshu	no_postings
tantan	no_postings
jiayuan	no_postings
baihe	no_postings
zhenai	no_postings
珍爱网	http_400
youyuan	no_postings
百合网	http_400
世纪佳缘	http_400
我主良缘	http_400
有缘网	http_400
嫁我网	http_400
缘来客	http_400
中国红娘	http_400
爱在四季	http_400
相约中国	http_400
相伴一生	http_400
久久结婚	http_400
幸福婚恋	http_400
浪漫婚恋	http_400
阳光婚恋	http_400
甜蜜婚恋	http_400
缘分天空	http_400
月老网	http_400
真诚婚恋	http_400
缘分到	http_400
红娘网	http_400
鹊桥会	http_400
丘比特	http_400
花田网	http_400
伊对	http_400
他趣	http_400
积目	http_400
soul	no_postings
陌陌	http_400
探探	http_400
slack	no_postings
比心	http_400
teams	no_postings
zoom	no_postings
google meet	http_400
webex	no_postings
goto meeting	http_400
bluejeans	no_postings
riverside.fm	http_400
whereby	no_postings
mmhmm	no_postings
around	no_postings
loom	no_postings
squadcast	no_postings
zencastr	no_postings
spotify for podcasters	http_400
anchor	no_postings
podbean	no_postings
buzzsprout	no_postings
transistor	no_postings
simplecast	no_postings
megaphone	no_postings
art19	no_postings
acast	no_postings
spreaker	no_postings
castos	no_postings
captivate	no_postings
libsyn	no_postings
blubrry	no_postings
whooshkaa	no_postings
redcircle	no_postings
rss.com	http_400
fireside	no_postings
backtracks	no_postings
sounder	no_postings
magellan ai	http_400
chartable	no_postings
veritone	no_postings
podsights	no_postings
claritas	no_postings
gumball	no_postings
podscribe	no_postings
podder	no_postings
barometer	no_postings
triton digital	http_400
podtrac	no_postings
authentic	no_postings
spreaker network	http_400
megaphone spotify	http_400
acast network	http_400
podbean network	http_400
anchor spotify	http_400
gimlet	no_postings
spotify studios	http_400
parcast	no_postings
cutler media	http_400
the ringer	http_400
exactly right	http_400
higher ground	http_400
all things comedy	http_400
forever dog	http_400
wondery	no_postings
kast media	http_400
earwolf	no_postings
headgum	no_postings
audioboom	no_postings
qcode	no_postings
podglomerate	no_postings
futuro studios	http_400
grim & mild	http_400
realm	no_postings
pineapple street	http_400
radiotopia	no_postings
pushkin industries	http_400
crooked media	http_400
washington post audio	http_400
the atlantic	http_400
campside media	http_400
new york times audio	http_400
lemonada	no_postings
npr podcasts	http_400
wsj podcasts	http_400
cbc podcasts	http_400
abc audio	http_400
bbc podcasts	http_400
hulu	no_postings
pbs news hour	http_400
pbs	no_postings
amazon prime video	http_400
disney+	http_400
hbo max	http_400
paramount+	http_400
peacock	no_postings
youtube premium	http_400
apple tv+	http_400
sling tv	http_400
fubo tv	http_400
youtube tv	http_400
philo	no_postings
vidgo	no_postings
directv stream	http_400
spectrum tv	http_400
xfinity stream	http_400
frndly tv	http_400
cox contour	http_400
optimum tv	http_400
verizon fios	http_400
at&t tv	http_400
philo tv	http_400
hulu live tv	http_400
sling orange	http_400
dish network	http_400
vidgo tv	http_400
stirr	no_postings
frndly	no_postings
sling blue	http_400
pluto tv	http_400
tubi	no_postings
crackle	no_postings
movies anywhere	http_400
vudu	no_postings
fandango	no_postings
ultraviolet	no_postings
flixster	no_postings
hidive	no_postings
funimation	no_postings
vrv	no_postings
crunchyroll	no_postings
rooster teeth	http_400
retrocrush	no_postings
midnight pulp	http_400
anime network	http_400
acorn tv	http_400
mhz choice	http_400
screambox	no_postings
walter presents	http_400
britbox	no_postings
topic	no_postings
pongalo	no_postings
amc+	http_400
pantaya	no_postings
sundance now	http_400
vix	no_postings
shudder	no_postings
blim	no_postings
clarovideo	no_postings
telecine play	http_400
globo play	http_400
hbo go	http_400
hbo now	http_400
cinemax	no_postings
starz	no_postings
apple music	http_400
epix	no_postings
spotify	no_postings
mgm+	http_400
amazon music	http_400
youtube music	http_400
showtime	no_postings
tidal	no_postings
pandora	no_postings
iheart	no_postings
deezer	no_matching_jobs
soundcloud	no_postings
tunein	no_postings
audible	no_postings
scribd	no_postings
chirp	no_postings
libro.fm	http_400
audiobooks.com	http_400
hoopla	no_postings
libby	no_postings
overdrive	no_postings
downpour	no_postings
kindle unlimited	http_400
kobo plus	http_400
storytel	no_postings
bookmate	no_postings
nextory	no_postings
read aloud	http_400
capti	no_postings
bookbeat	no_postings
play.ht	http_400
speechify	no_postings
podimo	no_postings
booklava	no_postings
voice dream	http_400
talk free	http_400
natural reader	http_400
narrator's voice	http_400
beek	no_postings
text to speech	http_400
hibooks	no_postings
balabolka	no_postings
natural readers	http_400
acapela	no_postings
cereproc	no_postings
ivona	no_postings
nuance	no_postings
neospeech	no_postings
cepstral	no_postings
loquendo	no_postings
nextup	no_postings
ultra hal	http_400
read&write gold	http_400
reading bar	http_400
readhow	no_postings
panopreter	no_postings
wynn wizard	http_400
zabaware	no_postings
text speaker	http_400
claroread	no_postings
podchaser	no_postings
browsealoud	no_postings
kurzweil	no_postings
verbose	no_postings
listen notes	http_400
dolphin easyreader	http_400
openbook	no_postings
readspeaker	no_postings
pocket casts	http_400
overcast	no_postings
castro	no_postings
castbox	no_postings
stitcher	no_postings
podcast addict	http_400
player fm	http_400
podcast republic	http_400
podbean app	http_400
google podcasts	http_400
breaker	no_postings
apple podcasts	http_400
luminary	no_postings
laughable	no_postings
instacast	no_postings
huffduffer	no_postings
downcast	no_postings
himalaya	no_postings
podkicker	no_postings
podcast guru	http_400
podcast go	http_400
spreaker studio	http_400
acast app	http_400
beyondpod	no_postings
feedburner	no_postings
blubrry stats	http_400
doggcatcher	no_postings
buzzsprout stats	http_400
activision blizzard	http_400
podbean stats	http_400
transistor stats	http_400
electronic arts	http_400
ea sports	http_400
ea dice	http_400
respawn	no_postings
rockstar games	http_400
take-two interactive	http_400
bioware	no_postings
2k games	http_400
codemasters	no_postings
criterion	no_postings
ubisoft	no_postings
maxis	no_postings
popcap	no_postings
gearbox	no_postings
private division	http_400
rockstar north	http_400
zynga	no_postings
rockstar san diego	http_400
rockstar leeds	http_400
rockstar london	http_400
rockstar new england	http_400
rockstar toronto	http_400
valve corporation	http_400
half life	http_400
rockstar lincoln	http_400
rockstar india	http_400
portal	no_postings
riot games	http_400
league of legends	http_400
teamfight tactics	http_400
unreal tournament	http_400
team fortress	http_400
legends of runeterra	http_400
unreal engine	http_400
dota	no_postings
epic games	http_400
gears of war	http_400
valorant	no_postings
fortnite	no_postings
counter-strike	no_postings
infinity blade	http_400
bandai namco	http_400
elden ring	http_400
dark souls	http_400
tekken	no_postings
pac-man	no_postings
one piece	http_400
from software	http_400
dragon ball	http_400
naruto	no_postings
capcom	no_postings
street fighter	http_400
resident evil	http_400
ace attorney	http_400
monster hunter	http_400
devil may cry	http_400
mega man	http_400
konami	no_postings
silent hill	http_400
metal gear solid	http_400
final fantasy	http_400
pro evolution soccer	http_400
yugioh	no_postings
square enix	http_400
castlevania	no_postings
kingdom hearts	http_400
dragon quest	http_400
deus ex	http_400
tomb raider	http_400
hitman	no_postings
just cause	http_400
nier	no_postings
total war	http_400
sonic	no_postings
yakuza	no_postings
sega	no_postings
persona	no_postings
phantasy star	http_400
13 sentinels	http_400
vanillaware	no_postings
odin sphere	http_400
nippon ichi	http_400
bayonetta	no_postings
atlus	no_postings
disgaea	no_postings
dragon's crown	http_400
muramasa	no_postings
legend of heroes	http_400
danganronpa	no_postings
trails	no_postings
ys	no_postings
dead or alive	http_400
dynasty warriors	http_400
koei tecmo	http_400
falcom	no_postings
nioh	no_postings
fatal frame	http_400
atelier	no_postings
fire emblem	http_400
nintendo	no_postings
mario	no_postings
zelda	no_postings
pokemon	no_postings
animal crossing	http_400
smash bros	http_400
star fox	http_400
splatoon	no_postings
metroid	no_postings
donkey kong	http_400
kirby	no_postings
sony interactive	http_400
f-zero	no_postings
earthbound	no_postings
xenoblade	no_postings
playstation studios	http_400
naughty dog	http_400
santa monica	http_400
insomniac	no_postings
guerrilla games	http_400
sucker punch	http_400
team asobi	http_400
polyphony digital	http_400
media molecule	http_400
bend studio	http_400
housemarque	no_postings
bluepoint	no_postings
nixxes	no_postings
haven	no_postings
firewalk	no_postings
microsoft gaming	http_400
firesprite	no_postings
xbox game studios	http_400
turn 10	http_400
343 industries	http_400
destiny	no_postings
bungie	no_postings
coalition	no_postings
marathon	no_postings
playground games	http_400
mojang	no_postings
ninja theory	http_400
double fine	http_400
compulsion	no_postings
obsidian	no_postings
inxile	no_postings
undead labs	http_400
bethesda	no_postings
rare	no_postings
id software	http_400
arkane	no_postings
tango gameworks	http_400
alpha dog	http_400
machinegames	no_postings
roundhouse	no_postings
supergiant games	http_400
team cherry	http_400
dead cells	http_400
hollow knight	http_400
motion twin	http_400
silksong	no_postings
bastion	no_postings
studio mdhr	http_400
cuphead	no_postings
hades	no_postings
pyre	no_postings
the delicious last course	http_400
jotun	no_postings
thunderlotus	no_postings
sundered	no_postings
coffee stain	http_400
spiritfarer	no_postings
goat simulator	http_400
devolver digital	http_400
satisfactory	no_postings
hotline miami	http_400
sanctum	no_postings
katana zero	http_400
cult of the lamb	http_400
gris	no_postings
outer wilds	http_400
what remains of edith finch	http_400
neon white	http_400
kena bridge of spirits	http_400
annapurna interactive	http_400
stray	no_postings
giant squid	http_400
inscryption	no_postings
the pathless	http_400
raw fury	http_400
abzu	no_postings
gonner	no_postings
night school	http_400
kingdom	no_postings
sable	no_postings
norco	no_postings
oxenfree	no_postings
afterparty	no_postings
telltale games	http_400
the walking dead	http_400
skybound	no_postings
the wolf among us	http_400
borderlands tales	http_400
new tales from borderlands	http_400
batman	no_postings
versus evil	http_400
banner saga	http_400
pillars of eternity	http_400
wasteland	no_postings
tyranny	no_postings
avowed	no_postings
grounded	no_postings
pentiment	no_postings
team17	no_postings
outer worlds	http_400
worms	no_postings
overcooked	no_postings
my time at portia	http_400
escapists	no_postings
narita boy	http_400
yooka-laylee	no_postings
blasphemous	no_postings
klei entertainment	http_400
tinykin	no_postings
terraria	no_postings
re-logic	no_postings
don't starve	http_400
oxygen not included	http_400
mark of the ninja	http_400
invisible inc	http_400
griftlands	no_postings
stardew valley	http_400
concerned ape	http_400
ark survival evolved	http_400
studio wildcard	http_400
ark 2	http_400
coffee stain studios	http_400
valheim	no_postings
deep rock galactic	http_400
iron gate	http_400
ghost ship games	http_400
pocketpair	no_postings
palworld	no_postings
inside	no_postings
playdead	no_postings
emberlab	no_postings
craftopia	no_postings
quantic dream	http_400
kojima productions	http_400
limbo	no_postings
death stranding	http_400
detroit become human	http_400
heavy rain	http_400
beyond two souls	http_400
remedy entertainment	http_400
control	no_postings
alan wake	http_400
quantum break	http_400
max payne	http_400
steam	no_postings
epic games store	http_400
valve	no_postings
itch.io	http_400
gog	no_postings
humble bundle	http_400
cd projekt	http_400
game jolt	http_400
fanatical	no_postings
greenmangaming	no_postings
gamersgate	no_postings
indiegala	no_postings
nuuvem	no_postings
dlgamer	no_postings
wingamestore	no_postings
voidu	no_postings
chrono.gg	http_400
2game	no_postings
gamesplanet	no_postings
gamivo	no_postings
g2a	no_postings
kinguin	no_postings
instant gaming	http_400
eneba	no_postings
allkeyshop	no_postings
cdkeys	no_postings
gg.deals	http_400
reddit gamedeals	http_400
slickdeals gaming	http_400
cheapshark	no_postings
humblebundle	no_postings
isthereanydeal	no_postings
monthly	no_postings
discord nitro	http_400
ea play	http_400
trove	no_postings
choice	no_postings
xbox game pass	http_400
playstation plus	http_400
nintendo online	http_400
nvidia geforce now	http_400
google stadia	http_400
amazon luna	http_400
shadow	no_postings
parsec	no_postings
rainway	no_postings
moonlight	no_postings
steam link	http_400
xbox cloud	http_400
playstation now	http_400
utomik	no_postings
vortex	no_postings
blacknut	no_postings
antstream	no_postings
gloud	no_postings
netboom	no_postings
jump	no_postings
loudplay	no_postings
blade	no_postings
maximum settings	http_400
paperspace	no_postings
vectordash	no_postings
team liquid	http_400
cloud9	no_postings
faze clan	http_400
100 thieves	http_400
g2 esports	http_400
fnatic	no_postings
tsm	no_postings
navi	no_postings
natus vincere	http_400
team vitality	http_400
astralis	no_postings
evil geniuses	http_400
og	no_postings
team secret	http_400
edg	no_postings
gen.g	http_400
damwon	no_postings
drx	no_postings
fpx	no_postings
psg esports	http_400
t1	no_postings
blg	no_postings
lng	no_postings
rng	no_postings
tes	no_postings
jdg	no_postings
omg	no_postings
lgd	no_postings
ig	no_postings
vg	no_postings
newbee	no_postings
ehome	no_postings
vici gaming	http_400
psg.lgd	http_400
team spirit	http_400
virtus.pro	http_400
liquid dota	http_400
alliance	no_postings
eg dota	http_400
secret dota	http_400
nigma	no_postings
talon esports	http_400
gaimin gladiators	http_400
tundra	no_postings
shopify rebellion	http_400
thunder awaken	http_400
furia	no_postings
infamous	no_postings
mibr	no_postings
loud	no_postings
beastcoast	no_postings
pain	no_postings
imperial	no_postings
red canids	http_400
fluxo	no_postings
liberty	no_postings
vivo keyd	http_400
vikings	no_postings
los	no_postings
big	no_postings
vitality cs	http_400
mouz	no_postings
navi cs	http_400
faze cs	http_400
heroic	no_postings
liquid cs	http_400
complexity	no_postings
imperial cs	http_400
furia cs	http_400
ence	no_postings
nip	no_postings
meta quest	http_400
col cs	http_400
c9 cs	http_400
eg cs	http_400
oculus	no_postings
playstation vr	http_400
psvr	no_postings
htc vive	http_400
valve index	http_400
hp reverb	http_400
windows mixed reality	http_400
samsung odyssey	http_400
varjo	no_postings
pimax	no_postings
bigscreen beyond	http_400
pico	no_postings
lynx	no_postings
somnium	no_postings
arpara	no_postings
magic leap	http_400
apple vision pro	http_400
pancake	no_postings
shiftall	no_postings
decagear	no_postings
megane	no_postings
microsoft hololens	http_400
mad gaze	http_400
rokid	no_postings
nreal	no_postings
vuzix	no_postings
raptor	no_postings
epson moverio	http_400
oppo air glass	http_400
xiaomi wireless ar	http_400
tcl nxtwear	http_400
lenovo glasses	http_400
amazon echo frames	http_400
razer anzu	http_400
bose frames	http_400
lucyd	no_postings
fauna	no_postings
viture	no_postings
solos	no_postings
rokid max	http_400
nreal air	http_400
xreal	no_postings
rayneo	no_postings
thunderbird	no_postings
mad gaze glow	http_400
vuzix blade	http_400
epson moverio bt	http_400
north focals	http_400
google glass	http_400
spectacles	no_postings
intel vaunt	http_400
meta ray ban	http_400
snap spectacles	http_400
tsmc	no_postings
analog devices	http_400
texas instruments	http_400
samsung	no_postings
infineon	no_postings
on semiconductor	http_400
nxp	no_postings
stm	no_postings
renesas	no_postings
maxim	no_postings
microchip	no_matching_jobs
skyworks	no_postings
marvell	no_postings
qorvo	no_postings
western digital	http_400
micron	no_postings
seagate	no_postings
sk hynix	http_400
kioxia	no_matching_jobs
crucial	no_postings
corsair	no_postings
gskill	no_postings
kingston	no_postings
adata	no_postings
teamgroup	no_postings
sandisk	no_matching_jobs
pny	no_postings
patriot	no_postings
mushkin	no_postings
ocz	no_postings
silicon power	http_400
plextor	no_postings
transcend	no_postings
samsung memory	http_400
hynix	no_postings
lexar	no_postings
nanya	no_postings
micron memory	http_400
winbond	no_postings
etron	no_postings
elite	no_postings
zenith	no_postings
apacer	no_postings
strontium	no_postings
gigastone	no_postings
hp memory	http_400
dell memory	http_400
verbatim	no_postings
lenovo memory	http_400
toshiba memory	http_400
hitachi	no_postings
fujitsu	no_postings
applied materials	http_400
lam research	http_400
asml	no_postings
screen holdings	http_400
kla	no_postings
teradyne	no_postings
tokyo electron	http_400
kokusai electric	http_400
advantest	no_postings
asm international	http_400
semes	no_postings
disco	no_postings
ebara	no_postings
veeco	no_postings
entegris	no_postings
dupont	no_postings
sumco	no_postings
siltronic	no_postings
sk siltron	http_400
shin-etsu	no_postings
globalwafers	no_postings
rs technologies	http_400
wafer works	http_400
episil	no_postings
tianjin zhonghuan	http_400
awsc	no_postings
grinm	no_postings
nanjing guosheng	http_400
luoyang monocrystalline	http_400
jsmc	no_postings
wafer semiconductor	http_400
jinko solar wafers	http_400
longi wafers	http_400
zhonghuan	no_postings
tcl zhonghuan	http_400
canadian solar wafers	http_400
longi solar	http_400
jinkosolar	no_postings
canadian solar	http_400
ja solar	http_400
trina solar	http_400
first solar	http_400
hanwha qcells	http_400
yingli	no_postings
suntech	no_postings
sharp solar	http_400
risen energy	http_400
kyocera solar	http_400
panasonic solar	http_400
lg solar	http_400
rec solar	http_400
solarworld	no_postings
winaico	no_postings
solaria	no_postings
tesla solar	http_400
lg energy solution	http_400
samsung display	http_400
vivint solar	http_400
sunpower	no_postings
lg display	http_400
boe	no_postings
innolux	no_postings
tianma	no_postings
japan display	http_400
sharp	no_postings
auo	no_matching_jobs
visionox	no_postings
tianma micro	http_400
truly	no_postings
itech	no_postings
cec panda	http_400
panda	no_postings
csot	no_postings
kopin	no_postings
emagin	no_postings
seeya	no_postings
royole	no_postings
microoled	no_postings
sony display	http_400
sony semiconductor	http_400
olightek	no_postings
jade bird display	http_400
panasonic displays	http_400
epson displays	http_400
hitachi displays	http_400
mitsubishi	no_postings
toshiba displays	http_400
nec displays	http_400
fujitsu displays	http_400
viewsonic	no_postings
benq	no_postings
acer displays	http_400
asus displays	http_400
dell displays	http_400
gigabyte displays	http_400
hp displays	http_400
lenovo displays	http_400
msi displays	http_400
nothing displays	http_400
samsung monitors	http_400
oneplus displays	http_400
xiaomi displays	http_400
huawei displays	http_400
spectre	no_postings
vivo displays	http_400
philips monitors	http_400
oppo displays	http_400
tcl displays	http_400
lg monitors	http_400
realme displays	http_400
aoc	no_postings
skyworth displays	http_400
hisense displays	http_400
juniper	no_postings
palo alto networks	http_400
arista	no_postings
f5	no_postings
a10 networks	http_400
extreme networks	http_400
ericsson	no_postings
nokia	no_postings
huawei	no_postings
zte	no_postings
fujitsu networks	http_400
ribbon communications	http_400
samsung networks	http_400
ciena	no_postings
adva	no_postings
corning	no_postings
infinera	no_postings
nec	no_postings
adtran	no_postings
general cable	http_400
prysmian	no_postings
commscope	no_postings
nexans	no_postings
southwire	no_postings
belden	no_postings
amphenol	no_postings
te connectivity	http_400
molex	no_postings
harting	no_postings
samtec	no_postings
phoenix contact	http_400
weidmuller	no_postings
schneider electric	http_400
wago	no_postings
eaton	no_postings
siemens networking	http_400
eaton network	http_400
abb networking	http_400
emerson network power	http_400
vertiv	no_postings
riello	no_postings
schneider apc	http_400
chloride	no_postings
benning	no_postings
borri	no_postings
himoinsa	no_postings
liebert	no_postings
socomec	no_postings
masterguard	no_postings
sdmo	no_postings
kohler power	http_400
caterpillar power	http_400
cummins power	http_400
mtu power	http_400
wärtsilä	http_400
rolls royce power	http_400
perkins	no_postings
kubota engines	http_400
yanmar	no_postings
deutz	no_postings
honda power	http_400
briggs stratton	http_400
yamaha power	http_400
kawasaki engines	http_400
subaru power	http_400
generac	no_postings
champion power	http_400
firman	no_postings
westinghouse	no_postings
duromax	no_postings
powermate	no_postings
predator	no_postings
wen	no_postings
durostar	no_postings
pulsetech	no_postings
sportsman	no_postings
yamaha generators	http_400
honda generators	http_400
subaru generators	http_400
dell emc	http_400
pure storage	http_400
netapp	no_postings
hewlett packard enterprise	http_400
hpe storage	http_400
nutanix	no_postings
hitachi vantara	http_400
lenovo storage	http_400
ibm storage	http_400
huawei storage	http_400
toshiba storage	http_400
supermicro	no_postings
inspur	no_postings
micron storage	http_400
crucial storage	http_400
kioxia storage	http_400
wd	no_postings
sk hynix storage	http_400
intel storage	http_400
samsung storage	http_400
synology	no_postings
qnap	no_postings
netgear storage	http_400
terramaster	no_postings
asustor	no_postings
buffalo	no_postings
western digital my cloud	http_400
drobo	no_postings
seagate personal cloud	http_400
g-technology	no_postings
lacie	no_postings
sandisk professional	http_400
wd easystore	http_400
wd elements	http_400
samsung portable ssd	http_400
seagate expansion	http_400
toshiba canvio	http_400
seagate backup plus	http_400
crucial x8	http_400
sandisk extreme	http_400
kingston storage	http_400
corsair storage	http_400
mushkin storage	http_400
patriot storage	http_400
crucial x6	http_400
teamgroup storage	http_400
pny storage	http_400
gskill storage	http_400
lexar storage	http_400
verbatim storage	http_400
lenovo	no_postings
cisco ucs	http_400
huawei servers	http_400
asus servers	http_400
gigabyte servers	http_400
sugon	no_postings
tyan	no_postings
quanta	no_postings
inventec	no_postings
foxconn servers	http_400
wistron	no_postings
pegatron	no_postings
asustek	no_postings
micro-star	no_postings
compal	no_postings
kontron	no_postings
aaeon	no_postings
advantech	no_postings
portwell	no_postings
biostar	no_postings
iei	no_postings
arbor	no_postings
vecow	no_postings
axiomtek	no_postings
nexcom	no_postings
neousys	no_postings
cincoze	no_postings
sintrones	no_postings
lanner	no_postings
syslogic	no_postings
avalue	no_postings
ibase	no_postings
iei integration	http_400
bcm advanced	http_400
artesyn	no_postings
emerson network	http_400
corsair psu	http_400
lite-on	no_postings
delta electronics	http_400
evga	no_postings
cooler master	http_400
acbel	no_postings
fsp	no_postings
seasonic	no_postings
thermaltake	no_postings
fractal design	http_400
be quiet	http_400
nzxt	no_postings
antec	no_postings
silverstone	no_postings
lian li	http_400
in win	http_400
phanteks	no_postings
raijintek	no_postings
enermax	no_postings
deepcool	no_postings
super flower	http_400
rosewill	no_postings
cougar	no_postings
darkflash	no_postings
gamemax	no_postings
aerocool	no_postings
vetroo	no_postings
montech	no_postings
segotep	no_postings
jonsbo	no_postings
metallic gear	http_400
xigmatek	no_postings
sama	no_postings
zalman	no_postings
silverstone tek	http_400
verizon	no_postings
us cellular	http_400
boost mobile	http_400
t-mobile	no_postings
sprint	no_postings
at&t	http_400
dish wireless	http_400
metro pcs	http_400
cricket	no_postings
mint mobile	http_400
visible	no_postings
spectrum mobile	http_400
xfinity mobile	http_400
cox mobile	http_400
optimum mobile	http_400
us mobile	http_400
red pocket	http_400
google fi	http_400
tello	no_postings
tracfone	no_postings
simple mobile	http_400
ting	no_postings
straight talk	http_400
total wireless	http_400
safelink	no_postings
net10	no_postings
page plus	http_400
consumer cellular	http_400
pure talk usa	http_400
jitterbug	no_postings
lively	no_postings
greatcall	no_postings
republic wireless	http_400
textnow	no_postings
freedompop	no_postings
textme	no_postings
dingtone	no_postings
textplus	no_postings
burner	no_postings
hushed	no_postings
openphone	no_postings
nextplus	no_postings
magicjack	no_postings
vonage	no_postings
sideline	no_postings
ooma	no_postings
grasshopper	no_postings
line2	no_matching_jobs
ringcentral	no_postings
voip.ms	http_400
phone.com	http_400
plivo	no_postings
telnyx	no_postings
flowroute	no_postings
callcentric	no_postings
nexmo	no_postings
twilio	no_postings
vonage api	http_400
inteliquent	no_postings
bandwidth	no_postings
signalwire	no_postings
level 3	http_400
peerless network	http_400
centurylink	no_postings
cincinnati bell	http_400
granite	no_postings
lumen	no_postings
broadview	no_postings
windstream	no_postings
earthlink	no_postings
consolidated	no_postings
frontier	no_postings
megapath	no_postings
cbeyond	no_postings
global crossing	http_400
tw telecom	http_400
electric lightwave	http_400
paetec	no_postings
xo	no_postings
nextlink	no_postings
eschelon	no_postings
mcleodusa	no_postings
sprint nextel	http_400
broadwing	no_postings
qwest	no_postings
alltel	no_postings
airtouch	no_postings
cellular one	http_400
ameritech	no_postings
pacific telesis	http_400
southwestern bell	http_400
bell south	http_400
nynex	no_postings
bell atlantic	http_400
vodafone	no_postings
gte	no_postings
orange	no_postings
movistar	no_postings
telefonica	no_postings
bell canada	http_400
telus	no_postings
rogers	no_postings
tbaytel	no_postings
northwestel	no_postings
mts	no_postings
ice wireless	http_400
shaw	no_postings
sasktel	no_postings
eastlink	no_postings
dta	no_postings
videotron	no_matching_jobs
nwt	no_postings
ssimicro	no_postings
lynx mobility	http_400
dt	no_postings
deutsche telekom	http_400
telekom austria	http_400
a1 telekom	http_400
swisscom	no_postings
proximus	no_postings
magenta	no_postings
tmobile austria	http_400
three austria	http_400
kpn	no_matching_jobs
salt mobile	http_400
ice norway	http_400
virgin media	http_400
sunrise	no_postings
telia	no_postings
telenor	no_postings
tdc	no_postings
tele2	no_postings
dna	no_postings
elisa	no_postings
moi	no_postings
bt	no_postings
o2	no_postings
ee	no_postings
three uk	http_400
sky mobile	http_400
smarty	no_postings
giffgaff	no_postings
lebara	no_postings
lycamobile	no_postings
asda mobile	http_400
post office	http_400
plusnet	no_postings
talktalk	no_postings
the phone coop	http_400
utility warehouse	http_400
wind tre	http_400
telecom italia	http_400
tim	no_postings
telecom argentina	http_400
vodafone italy	http_400
iliad italy	http_400
claro americas	http_400
fastweb	no_postings
infostrati	no_postings
tiscali	no_postings
movistar americas	http_400
orange france	http_400
personal	no_postings
sfr	no_postings
free mobile	http_400
la poste mobile	http_400
red by sfr	http_400
bouygues	no_postings
sosh	no_postings
b&you	http_400
nrj mobile	http_400
prixtel	no_postings
coriolis	no_postings
lycamobile france	http_400
charter spectrum	http_400
reglo mobile	http_400
lebara france	http_400
cox	no_postings
comcast	no_postings
altice	no_postings
cable one	http_400
suddenlink	no_postings
cablevision	no_postings
sparklight	no_postings
mediacom	no_matching_jobs
optimum	no_postings
atlantic broadband	http_400
grande	no_postings
rcn	no_postings
wow	no_postings
astound	no_postings
wideopenwest	no_postings
wave	no_postings
service electric	http_400
midcontinent	no_postings
blue ridge	http_400
armstrong	no_postings
cableamerica	no_postings
northland	no_postings
frontier communications	http_400
consolidated communications	http_400
quantum fiber	http_400
atlantic	no_postings
bright speed	http_400
ziply fiber	http_400
buckeye	no_postings
kinetic	no_postings
att fiber	http_400
earthlink fiber	http_400
google fiber	http_400
rise broadband	http_400
verizon lte home	http_400
t-mobile home	http_400
webpass	no_postings
starry	no_postings
att fixed wireless	http_400
tmobile internet	http_400
hughesnet	no_postings
starlink	no_postings
spectrum tv choice	http_400
xfinity flex	http_400
viasat	no_postings
sling	no_postings
directv	no_postings
optimum core tv	http_400
fios tv	http_400
cox contour stream	http_400
hulu live	http_400
tubi tv	http_400
roku channel	http_400
stirr tv	http_400
plex	no_postings
xumo	no_postings
freevee	no_postings
vudu free	http_400
peacock free	http_400
service cloud	http_400
commerce cloud	http_400
marketing cloud	http_400
mulesoft	no_postings
workday	no_postings
microsoft dynamics	http_400
hubspot	no_postings
servicenow	no_matching_jobs
float	no_postings
forecast	no_postings
zendesk	no_postings
zoho	no_postings
freshworks	no_matching_jobs
function point	http_400
project.co	http_400
runn	no_postings
avaza	no_postings
resource guru	http_400
workamajig	no_postings
productive	no_postings
accelo	no_postings
bqe core	http_400
synergist	no_postings
streamtime	no_postings
advantage	no_postings
cmap	no_postings
deltek	no_postings
kantata	no_postings
kimble	no_postings
epicor	no_postings
ifs	no_postings
infor	no_postings
netsuite	no_postings
sage intacct	http_400
quickbooks enterprise	http_400
xero	no_postings
freshbooks	no_postings
zoho books	http_400
kashoo	no_postings
akaunting	no_postings
invoice ninja	http_400
manager	no_postings
gnucash	no_postings
kill bill	http_400
crater	no_postings
billy	no_postings
pandle	no_postings
senta	no_postings
clear books	http_400
crunch	no_postings
freeagent	no_postings
gofreeserve	no_postings
quickfile	no_postings
andica	no_postings
sage business cloud	http_400
sage 50	http_400
sage 100	http_400
sage 300	http_400
sage 500	http_400
sage x3	http_400
sage people	http_400
sage payroll	http_400
adp	no_postings
paylocity	no_postings
ultimate software	http_400
ukg	no_postings
paychex	no_postings
kronos	no_postings
paycom	no_postings
namely	no_matching_jobs
zenefits	no_matching_jobs
bamboohr	no_postings
gusto	no_postings
rippling	no_postings
trinet	no_postings
justworks	no_matching_jobs
insperity	no_postings
oasis	no_postings
paycor	no_postings
ceridian	no_postings
dayforce	no_postings
proliant	no_postings
isolved	no_postings
patriot software	http_400
surepayroll	no_postings
evolution	no_matching_jobs
onpay	no_postings
square payroll	http_400
quickbooks payroll	http_400
waveapps payroll	http_400
homebase	no_postings
deputy	no_postings
tanda	no_postings
when i work	http_400
findmyshift	no_postings
shiftboard	no_postings
7shifts	no_postings
schedulefly	no_postings
humanity	no_postings
zip schedules	http_400
quinyx	no_postings
planday	no_postings
hotschedules	no_postings
timeforge	no_postings
fourth	no_postings
crunchtime	no_postings
7punches	no_postings
typsy	no_postings
staff squared	http_400
rotacloud	no_postings
orbital shift	http_400
ameego	no_postings
bizimply	no_postings
snap schedule	http_400
tandemploy	no_postings
shiftplanning	no_postings
employee scheduling	http_400
schedule maker	http_400
work schedule	http_400
staff roster	http_400
crew scheduler	http_400
team scheduling	http_400
rotation planner	http_400
shift scheduler	http_400
work roster	http_400
rota planner	http_400
duty roster	http_400
employee rota	http_400
shift rota	http_400
staff planner	http_400
staff scheduler	http_400
workforce scheduler	http_400
labour scheduler	http_400
intuit	no_postings
quickbooks	no_postings
credit karma	http_400
turbotax	no_postings
mint	no_postings
oracle financials	http_400
sage	no_postings
workday financials	http_400
mailchimp	no_postings
blackline	no_postings
floqast	no_postings
trintech	no_postings
prophix	no_postings
onestream	no_postings
certent	no_postings
board	no_postings
longview	no_postings
adaptive insights	http_400
anaplan	no_postings
planful	no_postings
vena	no_postings
host analytics	http_400
datarails	no_postings
tidemark	no_postings
jedox	no_postings
kaufman hall	http_400
axiom	no_postings
tagetik	no_postings
lucanet	no_postings
bpc	no_postings
ibm planning analytics	http_400
essbase	no_postings
cognos tm1	http_400
planning analytics	http_400
tm1	no_postings
hyperion	no_postings
sap analytics cloud	http_400
oracle epm	http_400
sap bpc	http_400
oracle hyperion	http_400
microsoft power bi	http_400
stata	no_postings
sas	no_postings
spss	no_postings
matlab	no_postings
mathematica	no_postings
r studio	http_400
pandas	no_postings
numpy	no_postings
python	no_postings
scipy	no_postings
scikit-learn	no_postings
tensorflow	no_postings
pytorch	no_postings
keras	no_postings
mxnet	no_postings
theano	no_postings
lasagne	no_postings
chainer	no_postings
caffe	no_postings
cntk	no_postings
megengine	no_postings
oneflow	no_postings
paddle	no_postings
mindspore	no_postings
jax	no_postings
flax	no_postings
marketo	no_postings
eloqua	no_postings
pardot	no_postings
constant contact	http_400
campaign monitor	http_400
brevo	no_postings
sendinblue	no_postings
activecampaign	no_postings
drip	no_postings
omnisend	no_postings
klaviyo	no_postings
convertkit	no_postings
sendlane	no_postings
keap	no_postings
infusionsoft	no_postings
customer.io	http_400
ontraport	no_postings
getresponse	no_postings
autopilot	no_postings
braze	no_postings
aweber	no_postings
iterable	no_postings
freshpaint	no_postings
mparticle	no_postings
rudderstack	no_postings
segment	no_postings
heap	no_postings
mixpanel	no_postings
amplitude	no_postings
fullstory	no_postings
crazy egg	http_400
logrocket	no_postings
hotjar	no_postings
optimizely	no_postings
google optimize	http_400
vwo	no_postings
ab tasty	http_400
kameleoon	no_postings
nosto	no_postings
certona	no_postings
barilliance	no_postings
monetate	no_postings
dynamic yield	http_400
evergage	no_postings
constructor	no_postings
bloomreach	no_postings
findify	no_postings
coveo	no_postings
syte	no_postings
attraqt	no_postings
vue.ai	http_400
cortexica	no_postings
pixyle	no_postings
slyce	no_postings
google vision	http_400
nyris	no_postings
aws rekognition	http_400
clarifai	no_postings
azure computer vision	http_400
watson visual recognition	http_400
alibaba vision	http_400
baidu vision	http_400
tencent vision	http_400
wit.ai	http_400
cloudsight	no_postings
api.ai	http_400
imagga	no_postings
luis	no_postings
rasa	no_postings
snips	no_postings
mycroft	no_postings
yandex vision	http_400
kalliope	no_postings
leon	no_postings
stephanie	no_postings
viky	no_postings
lucida	no_postings
neon	no_postings
s.e.p.i.a	http_400
sepia	no_postings
jarvis	no_postings
friday	no_postings
ovos	no_postings
alexa	no_postings
google assistant	http_400
cortana	no_postings
siri	no_postings
bixby	no_postings
pure chat	http_400
help scout	http_400
tawk.to	http_400
freshdesk	no_postings
livechat	no_postings
olark	no_postings
crisp	no_postings
userlike	no_postings
tidio	no_postings
chatlio	no_postings
smartsupp	no_postings
chatra	no_postings
jivochat	no_postings
salesforce service	http_400
jira service desk	http_400
oracle service	http_400
zoho desk	http_400
sap service	http_400
freshservice	no_postings
kayako	no_postings
vision helpdesk	http_400
teamsuport	no_postings
deskpro	no_postings
sysaid	no_postings
happyfox	no_postings
vivantio	no_postings
track-it	no_postings
issuetrak	no_postings
hesk	no_postings
spiceworks	no_postings
uvdesk	no_postings
osticket	no_postings
freescout	no_postings
zammad	no_postings
handesk	no_postings
liberum	no_postings
helpy	no_postings
rocket.chat	http_400
trudesk	no_postings
erxes	no_postings
zulip	no_postings
wire	no_postings
element	no_postings
mattermost	no_postings
keybase	no_postings
instagram dm	http_400
whatsapp business	http_400
facebook messenger	http_400
linkedin messaging	http_400
twitter dm	http_400
wechat work	http_400
workplace	no_postings
feishu	no_postings
dingtalk	no_postings
lark	no_postings
workvivo	no_postings
yammer	no_postings
staffbase	no_postings
chatter	no_postings
smarp	no_postings
sociabble	no_matching_jobs
facebook workplace	http_400
blink	no_postings
speakap	no_postings
oak engage	http_400
microsoft viva	http_400
invotra	no_postings
reach	no_postings
unily	no_postings
haiilo	no_postings
firstup	no_postings
interact	no_postings
poppulo	no_postings
simpplr	no_matching_jobs
lumapps	no_postings
jive	no_postings
igloo	no_postings
claromentis	no_postings
happeo	no_postings
vanilla forums	http_400
verint	no_postings
telligent	no_postings
discourse	no_postings
nodebb	no_postings
flarum	no_postings
phpbb	no_postings
mybb	no_postings
burning board	http_400
vbulletin	no_postings
ipboard	no_postings
smf	no_postings
liquid planner	http_400
xenforo	no_postings
woltlab	no_postings
ms project	http_400
adobe workfront	http_400
ganttproject	no_postings
primavera	no_postings
openproject	no_postings
redmine	no_postings
shortcut	no_postings
taiga	no_postings
trac	no_postings
clubhouse	no_postings
linear	no_postings
height	no_postings
pivotal tracker	http_400
plane	no_postings
targetprocess	no_postings
rally	no_postings
versionone	no_postings
ca agile	http_400
jira align	http_400
productboard	no_postings
craft.io	http_400
roadmunk	no_postings
aha	no_postings
airfocus	no_postings
productplan	no_postings
chisel	no_postings
dragonboat	no_postings
rapidr	no_postings
roadmap	no_postings
hellonext	no_postings
feature upvote	http_400
canny	no_postings
feedback fish	http_400
uservoice	no_postings
frill	no_postings
upvoty	no_postings
noora	no_postings
feedbear	no_postings
sleekplan	no_postings
supportbench	no_postings
kampsite	no_postings
ducalis	no_postings
supahub	no_postings
beamer	no_postings
headway	no_postings
announcekit	no_postings
launchnotes	no_postings
changefeed	no_postings
producter	no_postings
releasepad	no_postings
products ops	http_400
cycle	no_postings
parlor	no_postings
harvestr	no_postings
figma	no_postings
adobe xd	http_400
sketch	no_postings
framer	no_postings
webflow	no_postings
protopie	no_postings
principle	no_postings
flinto	no_postings
origami	no_postings
invision	no_postings
marvel	no_postings
balsamiq	no_postings
axure	no_postings
justinmind	no_postings
mockplus	no_postings
uxpin	no_postings
pencil	no_postings
wireframe.cc	http_400
akira	no_postings
mockflow	no_postings
moqups	no_postings
vectr	no_postings
penpot	no_postings
gravit	no_postings
lunacy	no_postings
crello	no_postings
desygner	no_postings
snappa	no_postings
stencil	no_postings
relay that	http_400
wordswag	no_postings
quozio	no_postings
easil	no_postings
pablo	no_postings
typorama	no_postings
over	no_postings
phonto	no_postings
font candy	http_400
text on photos	http_400
add text	http_400
pic stitch	http_400
quote creator	http_400
pic collage	http_400
layout	no_postings
instasize	no_postings
unfold	no_postings
text plus	http_400
moldiv	no_postings
quote maker	http_400
mojo	no_postings
quik	no_postings
splice	no_matching_jobs
lumafusion	no_postings
kinemaster	no_postings
capcut	no_postings
videoleap	no_postings
inshot	no_postings
vllo	no_postings
premiere rush	http_400
filmora	no_postings
vn	no_postings
davinci resolve	http_400
imovie	no_postings
final cut pro	http_400
premiere pro	http_400
after effects	http_400
motion	no_postings
smoke	no_postings
nuke	no_postings
fusion	no_postings
maya	no_postings
houdini	no_postings
flame	no_postings
3ds max	http_400
cinema 4d	http_400
blender	no_postings
lightwave	no_postings
modo	no_postings
zbrush	no_postings
meshmixer	no_postings
sculptris	no_postings
mudbox	no_postings
tinkercad	no_postings
fusion 360	http_400
onshape	no_postings
solidworks	no_postings
inventor	no_postings
catia	no_postings
creo	no_postings
nx	no_postings
solid edge	http_400
freecad	no_postings
autocad	no_postings
revit	no_postings
librecad	no_postings
qcad	no_postings
draftsight	no_postings
openscad	no_postings
archicad	no_postings
vectorworks	no_postings
rhino	no_postings
sketchup	no_postings
dynamo	no_postings
xsplit	no_postings
streamlabs	no_postings
wirecast	no_postings
vmix	no_postings
obs studio	http_400
nvidia broadcast	http_400
mirillis	no_postings
lightstream	no_postings
restream	no_postings
prism	no_postings
castr	no_postings
switchboard	no_postings
source connect	http_400
streamyard	no_postings
gyre	no_postings
source live	http_400
sessionwire	no_postings
listento	no_postings
squad cast	http_400
audiomovers	no_postings
cleanfeed	no_postings
ipdt	no_postings
rockstreamer	no_postings
sessionlinkpro	no_postings
audiomover	no_postings
studio network	http_400
netmix pro	http_400
vsync	no_postings
dante	no_postings
ravenna	no_postings
livewire	no_postings
aes67	no_postings
madi	no_postings
ndi	no_postings
sdi	no_postings
srt	no_postings
rtmp	no_postings
zixi	no_postings
webrtc	no_postings
ant media	http_400
rist	no_postings
haivision	no_postings
wowza	no_postings
flussonic	no_postings
nginx rtmp	http_400
red5	no_postings
ffmpeg	no_postings
gstreamer	no_postings
nimble	no_postings
vlc	no_postings
kodi	no_postings
mpv	no_postings
potplayer	no_postings
mpc	no_postings
emby	no_postings
universal media server	http_400
jellyfin	no_postings
serviio	no_postings
ps3 media server	http_400
mezzmo	no_postings
twonky	no_postings
bubble upnp	http_400
minim server	http_400
asset upnp	http_400
roon	no_postings
audirvana	no_postings
jriver	no_postings
kooraroo	no_postings
musicbee	no_postings
foobar2000	no_postings
minimwatch	no_postings
winamp	no_postings
aimp	no_postings
mediamonkey	no_postings
clementine	no_postings
audacious	no_postings
strawberry	no_postings
rhythmbox	no_postings
deadbeef	no_postings
amarok	no_postings
cantata	no_postings
banshee	no_postings
gmpc	no_postings
sonata	no_postings
ario	no_postings
quodlibet	no_postings
unity	no_postings
cryengine	no_postings
godot	no_postings
rage	no_postings
lumberyard	no_postings
source	no_postings
anvil	no_postings
source 2	http_400
frostbite	no_postings
idtech	no_postings
fox engine	http_400
decima	no_postings
mt framework	http_400
re engine	http_400
hedgehog	no_postings
snowdrop	no_postings
luminous	no_postings
dunia	no_postings
creation engine	http_400
chrome	no_postings
gamebryo	no_postings
clausewitz	no_postings
red engine	http_400
ego	no_postings
northlight	no_postings
novalogic	no_postings
havok	no_postings
bullet	no_postings
physx	no_postings
ammo.js	http_400
box2d	no_postings
matter.js	http_400
ode	no_postings
cannon.js	http_400
chipmunk	no_postings
oimo.js	http_400
p2.js	http_400
planck.js	http_400
rapier	no_postings
ggez	no_postings
amethyst	no_postings
bevy	no_postings
piston	no_postings
fyrox	no_postings
bracket-lib	no_postings
specs	no_postings
macroquad	no_postings
legion	no_postings
hecs	no_postings
flecs	no_postings
entt	no_postings
unity dots	http_400
stride	no_postings
entitas	no_postings
love2d	no_postings
fna	no_postings
pygame	no_postings
defold	no_postings
monogame	no_postings
cocos2d	no_postings
raylib	no_postings
sdl	no_postings
sfml	no_postings
allegro	no_matching_jobs
glut	no_postings
irrlicht	no_postings
ogre	no_postings
glfw	no_postings
panda3d	no_postings
magnum	no_postings
bgfx	no_postings
filament	no_postings
orge3d	no_postings
wicked	no_postings
urho3d	no_postings
diligent	no_postings
torque3d	no_postings
atomic	no_postings
stencyl	no_postings
o3de	no_postings
gdevelop	no_postings
buildbox	no_postings
gamemaker	no_postings
rpg maker	http_400
superpowers	no_postings
construct	no_postings
ink	no_postings
twine	no_postings
ren'py	http_400
naninovel	no_postings
visual novel maker	http_400
boosteroid	no_postings
remotr	no_postings
antstream arcade	http_400
blade shadow	http_400
playkey	no_postings
hatch	no_postings
tyranobuilder	no_postings
carbon black	http_400
sentinelone	no_postings
crowdstrike	no_postings
trellix	no_postings
trend micro	http_400
bitdefender	no_postings
kaspersky	no_postings
cylance	no_postings
mcafee	no_postings
sophos	no_postings
eset	no_postings
avast	no_postings
avg	no_postings
norton	no_postings
webroot	no_postings
malwarebytes	no_postings
gdata	no_postings
f-secure	no_postings
avira	no_postings
bullguard	no_postings
emsisoft	no_postings
zemana	no_postings
adaware	no_postings
vipre	no_postings
comodo	no_postings
hitman pro	http_400
superantispyware	no_postings
spybot	no_postings
rkill	no_postings
bleeping computer	http_400
malware tips	http_400
adwcleaner	no_postings
tdsskiller	no_postings
junkware removal	http_400
farbar	no_postings
combofix	no_postings
roguekiller	no_postings
hybrid analysis	http_400
malware removal	http_400
virus total	http_400
any.run	http_400
joe sandbox	http_400
cuckoo	no_postings
recorded future	http_400
reversing labs	http_400
intezer	no_postings
digital shadows	http_400
flashpoint	no_postings
anomali	no_postings
mandiant	no_postings
cape	no_postings
threatstream	no_postings
vmray	no_postings
qualys	no_postings
zerofox	no_postings
rapid7	no_postings
burp suite	http_400
tenable	no_postings
nexpose	no_postings
acunetix	no_postings
nessus	no_postings
openvas	no_postings
zap	no_postings
w3af	no_postings
nikto	no_postings
sqlmap	no_postings
metasploit	no_postings
cobalt strike	http_400
core impact	http_400
black duck	http_400
fortify	no_postings
immunity	no_postings
contrast security	http_400
mend	no_postings
canvas	no_postings
menlo	no_postings
sqreen	no_postings
mobile iron	http_400
zscaler	no_postings
workspace one	http_400
lookout	no_postings
hdiv	no_postings
barracuda	no_postings
signalsciences	no_postings
forcepoint	no_postings
jamf	no_postings
netskope	no_matching_jobs
airwatch	no_postings
wandera	no_postings
intune	no_postings
manageengine	no_postings
kaseya	no_postings
connectwise	no_postings
n-able	no_postings
datto	no_postings
acronis	no_postings
arcserve	no_postings
veeam	no_postings
veritas	no_postings
rubrik	no_postings
cohesity	no_postings
mozy	no_postings
carbonite	no_postings
unitrends	no_postings
macrium	no_postings
commvault	no_postings
idrive	no_postings
clonezilla	no_postings
rescuezilla	no_postings
redo rescue	http_400
fog project	http_400
clonedeploy	no_postings
backblaze	no_postings
paragon	no_postings
acronis backup	http_400
iperius	no_postings
serva	no_postings
ventoy	no_postings
druva	no_postings
aomei	no_postings
crashplan	no_postings
wpeinternals	no_postings
sardu	no_postings
easeus	no_postings
xboot	no_postings
rufus	no_postings
winsetupfromusb	no_postings
unetbootin	no_postings
wintoflash	no_postings
etcher	no_postings
yumi	no_postings
wintousb	no_postings
minitool partition	http_400
aomei partition	http_400
easeus partition	http_400
parted magic	http_400
gparted	no_postings
partition wizard	http_400
acronis disk	http_400
stellar phoenix	http_400
partition master	http_400
tenorshare	no_postings
active partition	http_400
disk director	http_400
partition assistant	http_400
disk drill	http_400
wondershare recoverit	http_400
stellar	no_postings
recuva	no_postings
ontrack	no_postings
easus data recovery	http_400
diskgenius	no_postings
photorec	no_postings
minitool power data	http_400
r-studio	no_postings
testdisk	no_postings
icare	no_postings
tenorshare recovery	http_400
jihosoft	no_postings
apeaksoft	no_postings
iskysoft	no_postings
dr.fone	http_400
mo biledit	http_400
anyrecover	no_postings
fonelab	no_postings
foobar ipod	http_400
imobie	no_postings
fonedog	no_postings
yamipod	no_postings
syncios	no_postings
sharepod	no_postings
imyfone	no_postings
anytrans	no_postings
ultdata	no_postings
imazing	no_postings
copytrans	no_postings
senuti	no_postings
checkpoint	no_postings
fortinet	no_postings
watchguard	no_postings
sonicwall	no_postings
winamp ipod	http_400
media widget	http_400
palo alto	http_400
ml ipod	http_400
radware	no_postings
citrix	no_postings
avi networks	http_400
load balancer	http_400
nginx	no_postings
kuma	no_postings
appswitch	no_postings
linkerd	no_postings
kemp	no_postings
envoy	no_postings
alteon	no_postings
istio	no_postings
bigip	no_postings
servicemesh	no_postings
haproxy	no_postings
traefik	no_postings
netscaler	no_postings
maesh	no_postings
snapt	no_postings
loadmaster	no_postings
thunder	no_postings
zevenet	no_postings
kemptechnologies	no_postings
riverbed	no_postings
silver peak	http_400
vmware velocloud	http_400
citrix sd-wan	http_400
cisco viptela	http_400
aryaka	no_postings
cloudgenix	no_postings
nuage	no_postings
d-link	no_postings
tp-link	no_postings
cato	no_postings
ruckus	no_postings
versa	no_postings
meraki	no_postings
cambium	no_postings
viptela	no_postings
cisco meraki	http_400
aruba	no_postings
hp networking	http_400
dell networking	http_400
juniper networks	http_400
extreme	no_postings
linksys	no_postings
ubiquiti	no_postings
alcatel lucent	http_400
asus	no_postings
mikrotik	no_postings
netgear	no_postings
huawei enterprise	http_400
beyond trust	http_400
raisecom	no_postings
dcn	no_postings
maipu	no_postings
omada	no_postings
ping identity	http_400
onelogin	no_postings
ruijie	no_postings
auth0	no_postings
cyberark	no_postings
h3c	no_postings
sailpoint	no_postings
zte enterprise	http_400
forgerock	no_postings
microsoft entra	http_400
active directory	http_400
389 directory	http_400
radiant logic	http_400
azure ad	http_400
ldap	no_postings
apache directory	http_400
openldap	no_postings
saviynt	no_postings
okta	no_postings
red hat directory	http_400
rippling identity	http_400
novell edirectory	http_400
workos	no_postings
oracle directory	http_400
simplesa mlphp	http_400
clerk	no_postings
apereo cas	http_400
supertokens	no_postings
authelia	no_postings
kanidm	no_postings
logto	no_postings
shibboleth	no_postings
privacyidea	no_postings
casdoor	no_postings
zitadel	no_postings
fusionauth	no_postings
lemonldap	no_postings
keycloak	no_postings
jumpcloud	no_postings
freeipa	no_postings
ory	no_postings
wso2	no_postings
google workspace	http_400
hanko	no_postings
gluu	no_postings
corbado	no_postings
transmit security	http_400
symantec vip	http_400
magic link	http_400
stytch	no_postings
cidaas	no_postings
rsa securid	http_400
descope	no_postings
microsoft authenticator	http_400
beyond identity	http_400
yubikey	no_postings
frontegg	no_postings
loginradius	no_postings
identrust	no_postings
authy	no_postings
sectigo	no_matching_jobs
digicert	no_postings
globalsign	no_postings
ssl.com	http_400
godaddy	no_postings
actalis	no_postings
izenpe	no_postings
buypass	no_postings
letsencrypt	no_postings
trustwave	no_postings
zerossl	no_postings
certum	no_postings
camerfirma	no_postings
accv	no_postings
google authenticator	http_400
passwordless	no_postings
ancert	no_postings
swisssign	no_postings
duo mobile	http_400
entrust	no_postings
webauthn	no_postings
gemalto	no_postings
fido2	no_postings
indykite	no_postings
thales	no_matching_jobs
asgardeo	no_postings
general dynamics	http_400
lockheed martin	http_400
wosign	no_postings
quovadis	no_postings
boeing	no_postings
northrop grumman	http_400
startcom	no_postings
l3harris	no_postings
raytheon	no_postings
textron	no_postings
huntington ingalls	http_400
bae systems	http_400
general atomics	http_400
leidos	no_postings
booz allen	http_400
kbr	no_postings
aecom	no_postings
saic	no_postings
fluor	no_postings
jacobs	no_postings
peraton	no_postings
parsons	no_postings
bechtel	no_postings
mantech	no_postings
caci	no_matching_jobs
mack defense	http_400
am general	http_400
amentum	no_postings
ge aviation	http_400
pratt whitney	http_400
v2x	no_postings
rockwell collins	http_400
collins aerospace	http_400
lear siegler	http_400
navistar defense	http_400
oshkosh	no_postings
vectrus	no_postings
rolls royce	http_400
eaton aerospace	http_400
honeywell aerospace	http_400
moog	no_postings
triumph group	http_400
parker aerospace	http_400
curtiss wright	http_400
orbital atk	http_400
woodward	no_postings
spirit aerosystems	http_400
safran	no_postings
aerovironment	no_postings
aerojet rocketdyne	http_400
airbus defense	http_400
saab	no_postings
elbit systems	http_400
rafael	no_postings
cubic	no_postings
mbda	no_postings
rheinmetall	no_postings
iai	no_postings
dassault	no_postings
leonardo	no_postings
kratos	no_postings
nammo	no_postings
kongsberg	no_postings
tkms	no_postings
naval group	http_400
knds	no_postings
hensoldt	no_postings
ffg	no_postings
navantia	no_postings
patria	no_postings
nexter	no_postings
gdels	no_postings
bofors	no_postings
daewoo shipbuilding	http_400
fincantieri	no_postings
pakistan aeronautical	http_400
samsung heavy	http_400
elbit brazil	http_400
high precision	http_400
hindustan aeronautics	http_400
turkish aerospace	http_400
hyundai heavy	http_400
ihi	no_postings
almaz antey	http_400
avibras	no_postings
cicaré	http_400
rostec	no_postings
subaru aerospace	http_400
mitsubishi heavy	http_400
concern morinformsystem	http_400
kawasaki heavy	http_400
uac	no_postings
united engine	http_400
tactical missiles	http_400
korean aerospace	http_400
iae	no_postings
embraer defense	http_400
fama	no_postings
oac	no_postings
ptdi	no_postings
nissan	no_postings
uralvagonzavod	no_postings
ksz	no_postings
khbm	no_postings
bmw	no_postings
kurganmashzavod	no_postings
hyundai	no_postings
mvz	no_postings
volvo	no_postings
stellantis	no_postings
kbm	no_postings
volkswagen	no_postings
great wall	http_400
guangzhou auto	http_400
jac motors	http_400
haval	no_postings
chery	no_postings
baic	no_postings
faw	no_postings
zotye	no_postings
lifan	no_postings
byd	no_postings
brilliance	no_postings
wey	no_postings
suzuki	no_postings
mazda	no_postings
renault	no_postings
general motors	http_400
mercedes-benz	no_postings
uspas	no_postings
kia	no_postings
ford	no_postings
geely	no_postings
dongfeng	no_postings
toyota	no_postings
changan	no_postings
honda	no_postings
lynk co	http_400
jetour	no_postings
tank	no_postings
ora	no_postings
polestar	no_postings
yangwang	no_postings
exeed	no_postings
fangchengbao	no_postings
zeekr	no_postings
smart	no_matching_jobs
avatr	no_postings
aion	no_postings
denza	no_postings
arcfox	no_postings
aito	no_postings
xpeng	no_postings
neta	no_postings
li auto	http_400
leapmotor	no_postings
worldcar	no_postings
hozon	no_postings
human horizons	http_400
dorcen	no_postings
nio	no_postings
weltmeister	no_postings
rivian	no_postings
fisker	no_postings
byton	no_postings
faraday future	http_400
aiways	no_postings
canoo	no_postings
lordstown	no_postings
arrival	no_postings
karma	no_postings
lucid	no_postings
mullen	no_postings
nikola	no_postings
hercules	no_postings
workhorse	no_postings
bollinger	no_postings
neuron	no_postings
aptera	no_postings
microlino	no_postings
sono	no_postings
lightyear	no_postings
alpha	no_postings
triton	no_postings
carver	no_postings
telo	no_postings
atlis	no_postings
birò	http_400
citroen ami	http_400
microletta	no_postings
arcimoto	no_postings
solo	no_postings
squad	no_postings
cupra born	http_400
seat mo	http_400
renault twizy	http_400
silence	no_postings
skoda enyaq	http_400
audi q4	http_400
alfa romeo tonale	http_400
maserati grecale	http_400
porsche taycan	http_400
ram 1500	http_400
jeep avenger	http_400
tesla model s	http_400
chrysler pacifica	http_400
tesla model x	http_400
lancia ypsilon	http_400
tesla model y	http_400
dodge hornet	http_400
fiat 500e	http_400
tesla model 3	http_400
tesla cybertruck	http_400
tesla roadster	http_400
tesla semi	http_400
aisin	no_postings
zf	no_postings
magna	no_postings
valeo	no_postings
denso	no_postings
bosch	no_postings
aptiv	no_postings
lear	no_postings
faurecia	no_postings
continental	no_matching_jobs
sumitomo	no_postings
yazaki	no_postings
toyoda gosei	http_400
pirelli	no_postings
goodyear	no_postings
michelin	no_postings
jtekt	no_postings
bridgestone	no_postings
marelli	no_postings
autoliv	no_postings
nsk	no_postings
koito	no_postings
continental tires	http_400
yokohama	no_postings
sumitomo rubber	http_400
hankook	no_postings
falken	no_postings
kumho	no_postings
cooper	no_postings
triangle	no_postings
nexen	no_postings
toyo	no_postings
linglong	no_postings
giti	no_postings
sailun	no_postings
wanli	no_postings
zhongce	no_postings
aeolus	no_postings
chaoyang	no_postings
doublestar	no_postings
wanda	no_postings
cst	no_postings
haida	no_postings
federal	no_postings
maxxis	no_postings
nankang	no_postings
kenda	no_postings
accelera	no_postings
nitto	no_postings
dick cepek	http_400
kelly	no_postings
dunlop	no_postings
fuzion	no_postings
bfgoodrich	no_postings
mastercraft	no_postings
uniroyal	no_postings
general	no_postings
firestone	no_postings
dayton	no_postings
fuzion tires	http_400
atlas	no_postings
ohtsu	no_postings
sigma	no_postings
westlake	no_postings
landsail	no_postings
roadone	no_postings
fortune	no_postings
vercelli	no_postings
lionhart	no_postings
atturo	no_postings
greenmax	no_postings
fullway	no_postings
lexani	no_postings
versatyre	no_postings
sava	no_postings
matador	no_postings
duro	no_postings
roadx	no_postings
zenna	no_postings
uniroyal europe	http_400
trayal	no_postings
barum	no_postings
arroyo	no_postings
semperit	no_postings
vogue	no_postings
pneumant	no_postings
debica	no_postings
fulda	no_postings
rigdon	no_postings
rosava	no_postings
belarus	no_postings
cordiant	no_postings
voltyre	no_postings
belshina	no_postings
yaroslavl	no_postings
kama	no_postings
nortec	no_postings
omskshina	no_postings
nizhnekamskshina	no_postings
pony.ai	http_400
argo ai	http_400
cruise	no_postings
uralshinotorg	no_postings
aurora	no_postings
altayshina	no_postings
tatshina	no_postings
waymo	no_postings
zoox	no_postings
motional	no_postings
autox	no_postings
momenta	no_postings
weride	no_postings
plus ai	http_400
tusimple	no_postings
embark	no_postings
locomation	no_postings
torc	no_postings
kodiak	no_postings
manna	no_postings
gatik	no_postings
nuro	no_postings
udelv	no_postings
starship	no_postings
kiwibot	no_postings
cartken	no_postings
refraction	no_postings
cleveron	no_postings
dispatch	no_postings
postmates serve	http_400
serve robotics	http_400
coco	no_postings
marble	no_postings
ottonomy	no_postings
boxbot	no_postings
tortoise	no_postings
fedex roxo	http_400
uber eats serve	http_400
amazon scout	http_400
boxbot delivery	http_400
kiwibot delivery	http_400
marble delivery	http_400
vayu	no_postings
starship delivery	http_400
may mobility	http_400
optimus ride	http_400
nuro r2	http_400
udelv newton	http_400
local motors	http_400
navya	no_postings
coast autonomous	http_400
easymile	no_postings
sensible 4	http_400
perrone	no_postings
transdev	no_postings
2getthere	no_postings
beep	no_postings
keolis	no_postings
transdev ats	http_400
first transit	http_400
ratp dev	http_400
stagecoach	no_postings
arriva	no_postings
go-ahead	no_postings
first group	http_400
stagecoach group	http_400
national express	http_400
lothian buses	http_400
abellio	no_postings
tower transit	http_400
veolia transport	http_400
downer edi	http_400
serco	no_postings
comfort delgro	http_400
sbs transit	http_400
smrt	no_postings
prasarana	no_postings
ktm	no_postings
rapid kl	http_400
flexport	no_postings
transfix	no_postings
fourkites	no_postings
uber freight	http_400
mrt	no_postings
convoy	no_postings
project44	no_postings
next trucking	http_400
loadsmart	no_postings
lrt	no_postings
cargomatic	no_postings
flock freight	http_400
axle	no_postings
shipwell	no_postings
doft	no_postings
parade	no_postings
freight farms	http_400
boulevard	no_postings
hwy haul	http_400
mothership	no_postings
outrider	no_postings
kodiak robotics	http_400
embark trucks	http_400
pronto ai	http_400
plus ai trucks	http_400
torc robotics	http_400
tusimple trucks	http_400
locomation trucks	http_400
ike	no_postings
einride	no_postings
starsky	no_postings
c3 ai logistics	http_400
peloton technology	http_400
coupa	no_postings
jaggaer	no_postings
ivalua	no_postings
zycus	no_postings
gep	no_postings
ariba	no_postings
taulia	no_postings
gt nexus	http_400
synertrade	no_postings
basware	no_postings
tradeshift	no_postings
e2open	no_postings
infor nexus	http_400
descartes	no_postings
manhattan	no_postings
blue yonder	http_400
sap logistics	http_400
highjump	no_postings
ifs logistics	http_400
oracle logistics	http_400
korber	no_postings
tecsys	no_postings
jda	no_postings
kinaxis	no_postings
logility	no_postings
llamasoft	no_postings
symphony retailai	http_400
toolsgroup	no_postings
daisy intelligence	http_400
relex	no_postings
celect	no_postings
antuit	no_postings
angel one	http_400
upstox	no_matching_jobs
zerodha	no_postings
fyers	no_postings
edelweiss	no_postings
5paisa	no_postings
icici direct	http_400
hdfc securities	http_400
axis direct	http_400
kotak securities	http_400
motilal oswal	http_400
iifl	no_postings
religare	no_postings
sharekhan	no_postings
anand rathi	http_400
geojit	no_postings
smc	no_postings
sushil finance	http_400
hem securities	http_400
mansukh	no_postings
swastika	no_postings
td ameritrade	http_400
charles schwab	http_400
smifs	no_postings
interactive brokers	http_400
etrade	no_postings
fidelity	no_postings
robinhood	no_postings
webull	no_postings
moomoo	no_postings
tastyworks	no_postings
tradestation	no_postings
thinkorswim	no_postings
centerpoint	no_postings
speedtrader	no_postings
trade ideas	http_400
trackn trade	http_400
cobra trading	http_400
suretrader	no_postings
trade-ideas	no_postings
tc2000	no_postings
finviz	no_postings
trendspider	no_postings
stockcharts	no_postings
tradingview	no_postings
coinigy	no_postings
sierra chart	http_400
bookmap	no_postings
tensorcharts	no_postings
cryptowatch	no_postings
ninjatrader	no_postings
quantower	no_postings
volfix	no_postings
multicharts	no_postings
order flow	http_400
jigsaw	no_postings
bookmap trading	http_400
atas	no_postings
quantower platform	http_400
volumetrica	no_postings
agena trader	http_400
volfix pro	http_400
investor rt	http_400
esignal	no_postings
telechart	no_postings
highcharts stock	http_400
worden	no_postings
qcharts	no_postings
stockfetcher	no_postings
tradecision	no_postings
amibroker	no_postings
pattern explorer	http_400
recognia	no_postings
chartpattern	no_postings
autochartist	no_postings
wealth-lab	no_postings
metastock	no_postings
stockalyze	no_postings
rightedge	no_postings
equity feed	http_400
quotetracker	no_postings
john deere	http_400
agco	no_postings
cnh industrial	http_400
kubota	no_postings
mahindra	no_postings
iseki	no_postings
same deutz-fahr	http_400
trimble	no_postings
fendt	no_postings
massey ferguson	http_400
challenger	no_postings
valtra	no_postings
claas	no_postings
raven	no_postings
precision planting	http_400
farmers edge	http_400
climate fieldview	http_400
ag leader	http_400
agrivi	no_postings
cropio	no_postings
farmobile	no_postings
granular	no_postings
hemisphere	no_postings
topcon	no_postings
dickey-john	no_postings
farmshots	no_postings
taranis	no_postings
agworld	no_postings
prospera	no_postings
adapt-n	no_postings
slingshot	no_postings
soiloptix	no_postings
descartes labs	http_400
croptix	no_postings
gamaya	no_postings
orbital insight	http_400
planet labs	http_400
hummingbird	no_postings
spaceknow	no_postings
urthecast	no_postings
qps research	http_400
capella space	http_400
si imaging services	http_400
satellogic	no_postings
blacksky	no_postings
umbra	no_postings
synspective	no_postings
maxar	no_postings
planet	no_postings
iceye	no_postings
digitalglobe	no_postings
geoeye	no_postings
quickbird	no_postings
ikonos	no_postings
worldview	no_postings
skysat	no_postings
rapideye	no_postings
pleiades	no_postings
aster	no_postings
sentinel	no_postings
landsat	no_postings
modis	no_postings
spot	no_postings
vision	no_postings
kompsat	no_postings
worldview legion	http_400
gaofen	no_postings
ziyuan	no_postings
eros	no_postings
yaogan	no_postings
jilin	no_postings
superview	no_postings
techsar	no_postings
ofek	no_postings
imagesat	no_postings
amos	no_postings
venus	no_postings
sigint	no_postings
comint	no_postings
elint	no_postings
imint	no_postings
masint	no_postings
humint	no_postings
cyber intelligence	http_400
osint	no_postings
geoint	no_postings
sar	no_postings
finint	no_postings
multispectral	no_postings
hyperspectral	no_postings
lidar	no_postings
infrared	no_postings
radar	no_postings
shortwave infrared	http_400
panchromatic	no_postings
optical	no_postings
synthetic aperture	http_400
active	no_postings
microwave	no_postings
near-infrared	no_postings
thermal	no_postings
passive	no_matching_jobs
ground penetrating	http_400
inverse sar	http_400
forward-looking	no_postings
side-looking	no_postings
bistatic	no_postings
multistatic	no_postings
differential	no_postings
persistent	no_postings
tomographic	no_postings
interferometric	no_postings
polarimetric	no_postings
coherent change	http_400
moving target	http_400
networked	no_postings
swarm	no_postings
gmti	no_postings
distributed	no_postings
maritime	no_postings
autonomous	no_postings
vehicular	no_postings
unmanned	no_postings
spaceborne	no_postings
handheld	no_postings
airborne	no_postings
federated	no_postings
ground-based	no_postings
cross-domain	no_postings
all-source	no_postings
multi-intelligence	no_postings
procore	no_postings
bluebeam	no_postings
autodesk construction cloud	http_400
leica geosystems	http_400
hilti	no_postings
plangrid	no_postings
bentley	no_postings
milwaukee	no_postings
makita	no_postings
bosch tools	http_400
black+decker	http_400
ridgid	no_postings
delta	no_postings
metabo	no_postings
dewalt	no_postings
festool	no_postings
jet	no_postings
ryobi	no_postings
craftsman	no_postings
porter-cable	no_postings
laguna	no_postings
felder	no_postings
sawstop	no_postings
grizzly	no_postings
hammer	no_postings
powermatic	no_postings
minimax	no_postings
scm	no_postings
altendorf	no_postings
martin	no_postings
rojek	no_postings
panhans	no_postings
striebig	no_postings
holzma	no_postings
beam saw	http_400
homag	no_postings
ima	no_postings
panel saw	http_400
scm group	http_400
cnc	no_postings
biesse	no_postings
weinig	no_postings
brandt	no_postings
edgebanders	no_postings
morbidelli	no_postings
cabinet saw	http_400
vertical panel saw	http_400
jobsite saw	http_400
contractor saw	http_400
sliding table saw	http_400
miter saw	http_400
radial arm saw	http_400
sliding compound	http_400
compound miter	http_400
cutoff saw	http_400
dual compound	http_400
chop saw	http_400
abrasive saw	http_400
metal chop saw	http_400
tct saw	http_400
cold saw	http_400
carbide saw	http_400
metal bandsaw	http_400
horizontal bandsaw	http_400
vertical bandsaw	http_400
friction saw	http_400
wood bandsaw	http_400
orbital jigsaw	http_400
scroll saw	http_400
resaw	no_postings
reciprocating saw	http_400
bandsaw	no_postings
demolition saw	http_400
tile saw	http_400
concrete saw	http_400
sawzall	no_postings
worm drive	http_400
masonry saw	http_400
wet saw	http_400
diamond saw	http_400
circular saw	http_400
sidewinder	no_postings
track saw	http_400
plunge saw	http_400
flooring saw	http_400
timber framing saw	http_400
tree care	http_400
electric chainsaw	http_400
chainsaw	no_postings
professional chainsaw	http_400
gas chainsaw	http_400
logging	no_postings
battery chainsaw	http_400
forestry	no_postings
pole saw	http_400
arborist	no_postings
felling	no_postings
pruning	no_postings
hedge trimmer	http_400
bucking	no_postings
limbing	no_postings
weed eater	http_400
lawn mower	http_400
brush cutter	http_400
string trimmer	http_400
zero turn	http_400
riding mower	http_400
push mower	http_400
robotic mower	http_400
reel mower	http_400
air compressor	http_400
plasma cutter	http_400
leaf blower	http_400
snow blower	http_400
generator	no_postings
pressure washer	http_400
stick welder	http_400
tig welder	http_400
mig welder	http_400
oxy-acetylene	no_postings
welder	no_postings
cutting torch	http_400
brazing torch	http_400
soldering iron	http_400
rosebud	no_postings
acetylene torch	http_400
hot air gun	http_400
spray gun	http_400
heat gun	http_400
paint sprayer	http_400
hvlp	no_postings
airless	no_postings
texture sprayer	http_400
taping knife	http_400
mud pan	http_400
drywall tools	http_400
disc sander	http_400
corner tool	http_400
orbital sander	http_400
oscillating tool	http_400
edge sander	http_400
spindle sander	http_400
belt sander	http_400
drum sander	http_400
sander	no_postings
multi-tool	no_postings
trim router	http_400
plunge router	http_400
combo router	http_400
router	no_postings
router table	http_400
moulder	no_postings
planer	no_postings
shaper	no_postings
wood shaper	http_400
jointer	no_postings
thickness planer	http_400
combination machine	http_400
dust collector	http_400
shop vac	http_400
downdraft table	http_400
central vacuum	http_400
air filtration	http_400
extractor	no_postings
soda blaster	http_400
powder coating	http_400
media blaster	http_400
paint booth	http_400
vapor blaster	http_400
spray booth	http_400
sandblaster	no_postings
wet blaster	http_400
abrasive blaster	http_400
basf	no_postings
dow	no_postings
lyondellbasell	no_postings
sabic	no_postings
sinopec	no_postings
ineos	no_postings
formosa plastics	http_400
exxonmobil chemical	http_400
braskem	no_postings
indorama	no_postings
mitsubishi chemical	http_400
toray	no_postings
sumitomo chemical	http_400
lg chem	http_400
lotte chemical	http_400
sk chemicals	http_400
hanwha solutions	http_400
gs caltex	http_400
sk innovation	http_400
kumho petrochemical	http_400
posco chemical	http_400
oci	no_postings
kolon	no_postings
hyosung	no_postings
s-oil	no_postings
kccp	no_postings
kpic	no_postings
hyundai oilbank	http_400
yeochun ncc	http_400
daehan oil	http_400
lgs	no_postings
kcc	no_postings
hankook shell	http_400
dongbu hannong	http_400
kyung in	http_400
kukdo	no_postings
dongsung	no_postings
lg mma	http_400
hanwha total	http_400
hanwha chemical	http_400
nam hae	http_400
lotte mcc	http_400
sk functional polymer	http_400
lg hausys	http_400
sk geo centric	http_400
kumho p&b	http_400
honam petrochemical	http_400
kumho mitsui	http_400
gs plastics	http_400
kohap	no_postings
samsung total	http_400
samsung bp	http_400
samsung fine chemicals	http_400
samsung sdi chemicals	http_400
sk materials	http_400
sk nexilis	http_400
sk ie technology	http_400
samsung electronics materials	http_400
posco chemicals	http_400
sk materials jrs	http_400
bhp	no_postings
rio tinto	http_400
china shenhua	http_400
agnico eagle	http_400
zijin mining	http_400
vale	no_postings
glencore	no_postings
shandong gold	http_400
polyus	no_postings
gold fields	http_400
eldorado	no_postings
newmont	no_postings
barrick gold	http_400
yamana	no_postings
kinross	no_postings
iamgold	no_postings
endeavour	no_postings
northern star	http_400
ramelius	no_postings
newcrest	no_postings
regis	no_postings
resolute	no_postings
red lake	http_400
calibre	no_postings
bellevue	no_postings
wesdome	no_postings
kirkland lake	http_400
detour gold	http_400
osisko	no_postings
americas gold	http_400
dynacor	no_postings
mcewen	no_postings
alamos	no_postings
primero	no_postings
torex	no_postings
lundin gold	http_400
buenaventura	no_postings
polymetal	no_postings
fresnillo	no_postings
aurico	no_matching_jobs
hochschild	no_postings
centerra	no_postings
mcewan copper	http_400
copper mountain	http_400
ivanhoe	no_postings
mandalay	no_postings
hudbay	no_postings
southern copper	http_400
freeport	no_postings
anglo american	http_400
antofagasta	no_postings
group mexico	http_400
kghm	no_postings
teck	no_postings
los bronces	http_400
codelco	no_postings
grasberg	no_postings
escondida	no_postings
los pelambres	http_400
collahuasi	no_postings
cerro verde	http_400
el teniente	http_400
chuquicamata	no_postings
las bambas	http_400
morenci	no_postings
antamina	no_postings
radomiro tomic	http_400
bingham canyon	http_400
spence	no_postings
quebrada blanca	http_400
caserones	no_postings
centinela	no_postings
minister hales	http_400
olympic dam	http_400
carrapateena	no_postings
prominent hill	http_400
rosemont	no_postings
northern dynasty	http_400
pebble	no_postings
donlin	no_postings
resolution	no_postings
livengood	no_postings
bornite	no_postings
shumagin	no_postings
whistler	no_postings
fort knox	http_400
dublin gulch	http_400
schaft creek	http_400
coffee	no_postings
pogo	no_postings
casino	no_postings
red chris	http_400
galore creek	http_400
mount milligan	http_400
rainy river	http_400
detour lake	http_400
musselwhite	no_postings
hemlo	no_postings
keno hill	http_400
holloway	no_postings
holt	no_postings
victoria gold	http_400
back river	http_400
hope bay	http_400
whale tail	http_400
meliadine	no_postings
meadowbank	no_postings
yellowknife	no_postings
amaruq	no_postings
gibson	no_postings
ekati	no_postings
gahcho kue	http_400
renard	no_postings
diavik	no_postings
victor	no_postings
snap lake	http_400
star	no_postings
orion	no_postings
attawapiskat	no_postings
fort rupert	http_400
winisk	no_postings
severn	no_postings
albany	no_postings
shamattawa	no_postings
marble island	http_400
seal	no_postings
churchill	no_postings
wager bay	http_400
roes welcome	http_400
saudi aramco	http_400
bp	no_postings
shell	no_postings
exxonmobil	no_postings
totalenergies	no_postings
chevron	no_postings
conocophillips	no_postings
petrochina	no_postings
gazprom	no_postings
rosneft	no_postings
lukoil	no_postings
petrobras	no_postings
eni	no_postings
repsol	no_postings
equinor	no_postings
pemex	no_postings
nnpc	no_postings
pdvsa	no_postings
qatarpetroleum	no_postings
kuwait petroleum	http_400
petronas	no_postings
ptt	no_postings
qatarenergy	no_postings
jx nippon	http_400
adnoc	no_postings
inpex	no_postings
tokyo gas	http_400
osaka gas	http_400
idemitsu	no_postings
ongc	no_postings
cosmo	no_postings
cnooc	no_postings
reliance	no_postings
oil india	http_400
iocl	no_postings
hindustan petroleum	http_400
bharat petroleum	http_400
petronet lng	http_400
mangalore refinery	http_400
gail	no_postings
chennai petroleum	http_400
bpcl kochi	http_400
numaligarh refinery	http_400
mrpl	no_postings
nrl	no_postings
hmel	no_postings
cpcl	no_postings
brpl	no_postings
hpcl mittal	http_400
barmer refinery	http_400
bongaigaon refinery	http_400
ratnagiri refinery	http_400
digboi refinery	http_400
haldia refinery	http_400
panipat refinery	http_400
guwahati refinery	http_400
mathura refinery	http_400
paradip refinery	http_400
mumbai refinery	http_400
koyali refinery	http_400
cauvery basin	http_400
nagapattinam	no_postings
krishna godavari	http_400
assam arakan	http_400
mahanadi	no_postings
mumbai offshore	http_400
cambay	no_matching_jobs
rajasthan	no_postings
kerala-konkan	no_postings
bengal	no_postings
son valley	http_400
vindhyan	no_postings
saurashtra	no_postings
kutch	no_postings
godavari	no_postings
satpura	no_postings
deccan	no_postings
nextera energy	http_400
narmada	no_postings
kerala basin	http_400
iberdrola	no_postings
cuddapah	no_postings
enel green power	http_400
edf renewables	http_400
rwe renewables	http_400
orsted	no_postings
engie	no_postings
acciona energia	http_400
jinko solar	http_400
trina solar energy	http_400
canadian solar solutions	http_400
jinkosolar holding	http_400
gcl	no_postings
ja solar holdings	http_400
aiko solar	http_400
flat glass	http_400
tongwei solar	http_400
xinyi solar	http_400
daqo new energy	http_400
asia silicon	http_400
csg holdings	http_400
wacker chemie	http_400
gcl-poly	no_postings
ocim	no_postings
renesola	no_matching_jobs
