netflix	no_jobs
google	no_jobs
microsoft	no_jobs
nvidia	no_jobs
tesla	no_career_page
amazon	no_jobs
oracle	no_jobs
salesforce	no_jobs
qualcomm	no_jobs
hp	no_jobs
amd	no_jobs
redhat	no_jobs
ibm	no_jobs
cisco	no_jobs
anthropic	no_jobs
alphabet	no_career_page
openai	no_career_page
suse	no_jobs
scaleai	no_career_page
hpe	no_jobs
cohere	no_jobs
huggingface	no_jobs
datarobot	no_jobs
palantir	no_jobs
databricks	no_jobs
c3ai	no_career_page
deepmind	no_jobs
runway	no_jobs
broadcom	no_jobs
writesonic	no_career_page
adept	no_jobs
perplexity	no_career_page
mistral	no_jobs
typeface	no_jobs
canonical	no_jobs
clari	no_jobs
salesloft	no_jobs
outreach	no_jobs
6sense	no_career_page
gong	no_career_page
demandbase	no_jobs
clearbit	no_career_page
intercom	no_jobs
drift	no_jobs
conjure	no_career_page
mixmax	no_jobs
calendly	no_jobs
qualified	no_career_page
vmware	no_career_page
intel	no_jobs
front	no_jobs
groove	no_career_page
spark	no_jobs
protonmail	no_jobs
newton	no_jobs
hey	no_career_page
spike	no_jobs
aws	no_jobs
canary	no_career_page
mailbird	no_career_page
midjourney	no_career_page
digitalocean	no_jobs
vultr	no_jobs
gcp	no_career_page
cloudflare	no_jobs
fastly	no_jobs
yesware	no_career_page
synthesia	no_career_page
incapsula	no_career_page
imperva	no_jobs
mongodb	no_jobs
polymail	no_career_page
redis	no_jobs
elasticsearch	no_jobs
elastic	no_career_page
algolia	no_jobs
meilisearch	no_jobs
azure	no_career_page
sucuri	no_career_page
confluent	no_career_page
hushmail	no_career_page
kafka	no_career_page
typesense	no_career_page
edgecast	no_career_page
jasper	no_jobs
opensearch	no_career_page
akamai	no_career_page
linode	no_career_page
